嗚呼	Ah!;Oh!;Alas!	
相	together;mutually;fellow	
相変わらず	as ever;as usual;the same	
愛想	civility;courtesy;compliments;sociability;graces	
相対	confrontation;facing;between ourselves;no third party;tete-a-tete	
間柄	relation(ship)	
愛憎	likes and dislikes	
合間	interval	
曖昧	vague;ambiguous	
敢えて	dare (to do);challenge (to do)	
仰ぐ	to look up (to);to respect;to depend on;to ask for;to seek;to revere;to drink;to take	
垢	dirt;filth	
亜科	suborder;subfamily	
銅	copper	
証	proof;evidence	
赤字	deficit;go in the red	
明かす	to pass;spend;to reveal;to divulge	
赤ちゃん	baby;infant	
明白	obvious;overt;plainly;frankly	
赤らむ	to become red;to redden;to blush	
明るい	bright;cheerful	
上がり	1.&nbsp;&nbsp;slope;advance income;crop yield;ascent;rise;advance;death;spinning;completion;stop;finish;after	
上がる	to enter;to go up;to rise;to climb up;to advance;to appreciate;to be promoted;to improve;to call on;	
商人	trader;shopkeeper;merchant	
空間	vacancy;room for rent or lease	
諦め	resignation;acceptance;consolation	
呆れる	to be amazed;to be shocked	
悪	evil;wickedness	
灰	puckery juice	
あくどい	1.&nbsp;&nbsp;gaudy;showy;excessive; 2.&nbsp;&nbsp;vicious	
悪日	unlucky day	
明くる	next;following	
憧れ	yearning;longing;aspiration	
顎	chin	
麻	flax;linen;hemp	
明後日	day after tomorrow	
朝寝坊	oversleeping;late riser	
浅ましい	wretched;miserable;shameful;mean;despicable;abject	
字	section of village	
欺く	to deceive	
鮮やか	vivid;clear;brilliant	
あざ笑う	to sneer at;to ridicule	
味わい	flavour;meaning;significance	
東	east;Eastern Japan	
焦る	to be in a hurry;to be impatient	
彼処	1.&nbsp;&nbsp;(uk) there;over there;that place; 2.&nbsp;&nbsp;(X) (col) genitals	
値	value;price;cost;worth;merit	
値する	to be worth;to deserve;to merit	
私	I (fem)	
当たり	hit;success;reaching the mark;per ...;vicinity;neighborhood	
当たり前	usual;common;ordinary;natural;reasonable;obvious	
他人	another person;unrelated person;outsider;stranger	
彼方此方	here and there	
彼方	1.&nbsp;&nbsp;there;yonder;that	
悪化	deterioration;growing worse;aggravation;degeneration;corruption	
呆気ない	not enough;too quick (short&nbsp;&nbsp;long&nbsp;&nbsp;etc.)	
悪口	abuse;insult;slander;evil speaking	
あっさり	easily;readily;quickly	
圧迫	pressure;coercion;oppression	
扱い	treatment;service	
集まる	to gather;to collect;to assemble	
誂える	to give an order;to place an order	
圧力	stress;pressure	
当て	object;aim;end;hopes;expectations	
宛	addressed to	
当て字	phonetic-equivalent character;substitute character	
当てはまる	to apply (a rule)	
当てはめる	to apply;to adapt	
宛てる	to address	
跡継ぎ	heir;successor	
後回し	putting off;postponing	
貴女	you;lady	
彼の	that over there	
溢れる	to flood;to overflow;to brim over	
油絵	oil painting	
炙る	to scorch	
あべこべ	contrary;opposite;inverse	
甘える	to behave like a spoiled child;to fawn on	
甘口	sweet flavour;mildness;flattery;stupidity	
雨具	rain gear	
天	heavenly;imperial	
網	net;network	
天地	heaven and earth;the universe;nature;top and bottom;realm;sphere;world	
操る	to manipulate;to operate;to pull strings	
あやふや	uncertain;vague;ambiguous	
危ぶむ	to fear;to have misgivings;to be doubtful;to mistrust	
過ち	fault;error;indiscretion	
誤る	to make a mistake	
歩み	walking	
歩む	to walk;to go on foot	
あら	oh;ah;saw-edged perch (Niphon spinosus)	
予め	beforehand;in advance;previously	
荒らす	to lay waste;to devastate;to damage;to invade;to break into	
粗筋	outline;summary	
争い	dispute;strife;quarrel;dissension;conflict;rivalry;contest	
改まる	to be renewed	
荒っぽい	rough;rude	
凡ゆる	all;every	
あられ	kind of cookie;cartoon character	
現われ	embodiment;materialization	
現われる	to appear;to come in sight;to become visible;to come out;to embody;to materialize;to express oneself	
有難う	Thank you	
有様	state;condition;circumstances;the way things are or should be;truth	
有りのまま	the truth;fact;as it is;frankly	
或る	a certain...;some...	
或いは	or;possibly	
彼此	one thing or another;this and that;this or that	
合わす	to join together;to face;to unite;to be opposite;to combine;to connect;to add up;to mix;to match;to	
合わせ	joint together;opposite;facing	
慌ただしい	busy;hurried;confused;flurried	
慌てる	to become confused (disconcerted&nbsp;&nbsp;disorganized)	
暗殺	assassination	
暗算	mental arithmetic	
暗示	hint;suggestion	
案じる	to be anxious;to ponder	
安静	rest	
案の定	sure enough;as usual	
余り	not very (this form only used as adverb);not much;remainder;rest;remnant;surplus;balance;excess;rema	
依	depending on	
良い	good	
伊井	that one;Italy	
否	no;nay;yes;well	
いい加減	moderate;right;random;not thorough;vague;irresponsible;halfhearted	
言い訳	excuse;explanation	
家出	running away from home;leaving home	
家主	landlord	
如何	how;in what way	
生かす	to revive;to resuscitate;to make use of	
雷	thunder	
如何に	how?;in what way?;how much?;however;whatever	
如何にも	indeed;really;phrase meaning agreement	
怒り	anger;hatred	
怒る	to get angry;to be angry	
歪む	to warp;to swerve;to deflect;to be crooked;to be distorted;to be bent;to incline;to slant;to be perv	
粋	chic;style;purity;essence	
域外	outside the area	
意気込む	to be enthusiastic about	
経緯	1.&nbsp;&nbsp;details;whole story;sequence of events;particulars;how it started;how things got this way; 2.&nbsp;&nbsp;c	
行き違い	misunderstanding;estrangement;disagreement;crossing without meeting;going astray	
行き成り	suddenly	
異議	objection;dissent;protest	
いく	to come;to orgasm	
軍	war;battle;campaign;fight	
戦	war;battle;campaign;fight	
育成	rearing;training;nurture;cultivation;promotion	
幾多	many;numerous	
活ける	to arrange (flowers)	
異見	different opinion;objection	
意向	intention;idea;inclination	
移行	switching over to	
いざ	now;come (now);well;crucial moment	
碑	stone monument bearing an inscription	
衣装	clothing;costume;outfit;garment;dress	
意地	disposition;spirit;willpower;obstinacy;backbone;appetite	
苛める	to tease;to torment;to persecute;to chastise	
移住	migration;immigration	
弄る	to touch;to tamper with	
何れ	where;which;who;anyway;anyhow;at any rate	
異性	the opposite sex	
遺跡	historic ruins (remains&nbsp;&nbsp;relics)	
依然	still;as yet	
依存	dependence;dependent;reliance	
委託	consign (goods (for sale) to a firm);entrust (person with something);commit	
悪戯	tease;prank;trick;practical joke;mischief	
頂	(top of) head;summit;spire	
戴きます	expression of gratitude before meals	
至って	very much;exceedingly;extremely	
痛む	to hurt;to feel a pain;to be injured	
痛める	to hurt;to injure;to cause pain;to worry;to bother;to afflict;to be grieved over	
炒める	to stir-fry	
労る	to pity;to sympathize with;to console;to care for;to be kind to	
市	market;fair	
位地	place;situation;position;location	
一々	one by one;separately	
一概に	unconditionally;as a rule	
一見	unfamiliar;never before met	
一言	single word	
一日	(1) one day, (2) first of month	
一定	fixed;settled;definite;uniform;regularized;defined;standardized;certain;prescribed	
著しい	remarkable;considerable	
一同	all present;all concerned;all of us	
一人	one person	
一部	1.&nbsp;&nbsp;one copy&nbsp;&nbsp;e.g. of a document; 2.&nbsp;&nbsp;a part;partly;some	
一部分	a part	
一別	parting	
一面	one side;one phase;front page;the other hand;the whole surface	
一目	a glance;a look;a glimpse	
一様	uniformity;evenness;similarity;equality;impartiality	
一律	evenness;uniformity;monotony;equality	
一連	a series;a chain;a ream (of paper)	
一括	all together;batch;one lump;one bundle;summing up	
一気	drink!(said repeatedly as a party cheer)	
一挙に	at a stroke;with a single swoop	
一切	all;everything;without exception;the whole;entirely;absolutely	
一心	one mind;wholeheartedness;the whole heart	
いっそ	rather;sooner;might as well	
一帯	a region;a zone;the whole place	
一敗	one defeat	
一変	complete change;about-face	
何時	when;how soon	
何時か	sometime;someday;one day;some time or other;the other day;in due course;in time	
何時でも	(at) any time;always;at all times;never (neg);whenever	
何時の間にか	before one knows;unnoticed;unawares	
何時までも	forever;for good;eternally;as long as one likes;indefinitely	
何時も	always;usually;every time;never (with neg. verb)	
意図	intention;aim;design	
営む	to carry on (e.g. in ceremony);to run a business	
暇	free time;leisure;leave;spare time;farewell	
異動	a change	
挑む	to challenge;to contend for;to make love to	
稲光	(flash of) lightning	
古	antiquity;ancient times	
祈り	prayer;supplication	
鼾	snoring	
今更	now;at this late hour	
未だ	as yet;hitherto;not yet (neg)	
移民	emigration;immigration;emigrant;immigrant	
厭々	unwillingly;grudgingly;shaking head in refusal (to children)	
卑しい	greedy;vulgar;shabby;humble;base;mean;vile	
いやに	awfully;terribly	
厭やらしい	detestable;disagreeable	
愈々	more and more;all the more;increasingly;at last;beyond doubt	
意欲	will;desire;ambition	
苛々	getting nervous;irritation	
入口	entrance;gate;approach;mouth	
衣料	clothing	
威力	power;might;authority;influence	
入る	to get in;to go in;to come in;to flow into;to set;to set in	
衣類	clothes;clothing;garments	
色々	various	
異論	different opinion;objection	
所謂	the so-called;so to speak	
印	seal;stamp;mark;print	
員	member	
印鑑	stamp;seal	
陰気	gloom;melancholy	
隠居	retirement;retired person	
上下	high and low;up and down;unloading and loading;praising and blaming	
浮かぶ	to float;to rise to surface;to come to mind	
受かる	to pass (examination)	
含嗽	gargle;rinse mouth	
受け入れ	receiving;acceptance	
受け入れる	to accept;to receive	
受け継ぐ	to inherit;to succeed;to take over	
受け付ける	to be accepted;to receive (an application)	
受け止める	to catch;to stop the blow;to react to;to take	
受け取り	receipt	
受身	passive;passive voice	
動き	movement;activity;trend;development;change	
潮	tide	
氏	family name	
渦	swirl	
埋まる	to be buried;to be surrounded;to overflow;to be filled	
嘘つき	liar (sometimes said with not much seriousness);fibber	
打ち合わせ	business meeting;previous arrangement;appointment	
打ち合わせる	to knock together;to arrange	
打ち切る	to stop;to abort;to discontinue;to close	
打ち消し	negation;denial;negative	
打ち込む	to drive in (e.g. nail&nbsp;&nbsp;stake);to devote oneself to;to shoot into;to smash;to throw into;to cast int	
団扇	fan	
内訳	the items;breakdown;classification	
訴え	lawsuit;complaint	
鬱陶しい	gloomy;depressing	
写し	copy;duplicate;facsimile;transcript	
空ろ	blank;cavity;hollow;empty (space)	
器	bowl;vessel;container	
雨天	rainy weather	
腕前	ability;skill;facility	
饂飩	noodles (Japanese)	
促す	to urge;to press;to suggest;to demand;to stimulate;to quicken;to incite;to invite (attention to)	
唸る	to groan;to moan;to roar;to howl;to growl;to hum;to buzz;to sough	
自惚れ	pretension;conceit;hubris	
甘い	delicious	
生まれつき	by nature;by birth;native	
海路	sea route	
産む	to give birth;to deliver;to produce	
埋め込む	to bury	
梅干	dried plum	
末	top end;tip	
裏返し	inside out;upside down	
売り出し	(bargain) sale	
売り出す	to put on sale;to market;to become popular	
潤う	to be moist;to be damp;to get wet;to profit by;to be watered;to receive benefits;to favor;to charm;t	
五月蝿い	noisy;loud;fussy	
売れ行き	sales	
浮気	flighty;fickle;wanton;unfaithful	
上手	1.&nbsp;&nbsp;upper part;upper stream;left side (of a stage); 2.&nbsp;&nbsp;skillful (only in comparisons);dexterity (on	
上回る	to exceed	
植わる	to be planted	
運営	management;administration;operation	
うんざり	tedious;boring;being fed up with	
運送	shipping;marine transportation	
運賃	freight rates;shipping expenses;fare	
云々	and so on;and so forth;comment	
運搬	transport;carriage	
運命	fate	
運輸	transportation	
運用	making use of;application;investment;practical use	
会	understanding	
重	-fold;-ply	
えい	ray (fish)	
映写	projection	
英字	English letter (character)	
衛生	health;hygiene;sanitation;medical	
映像	reflection;image	
英雄	hero;great man	
液	liquid;fluid	
役	war;campaign;battle	
閲覧	inspection;reading	
獲物	game;spoils;trophy	
襟	neck;collar;lapel;neckband	
縁	chance;fate;destiny;relation;bonds;connection;karma	
塩	salt	
艶	charming;fascinating;voluptuous	
園	garden (esp. man-made)	
円滑	harmony;smoothness	
縁側	veranda;porch;balcony;open corridor	
沿岸	coast;shore	
婉曲	euphemistic;circumlocution;roundabout;indirect;insinuating	
演習	practice;exercises;manoeuvers	
演出	production (e.g. play);direction	
演じる	to perform (a play);to play (a part);to act (a part);to commit (a blunder)	
演ずる	to perform;to play	
沿線	along railway line	
縁談	marriage proposal;engagement	
遠方	long way;distant place	
円満	perfection;harmony;peace;smoothness;completeness;satisfaction;integrity	
尾	tail;ridge	
於	at;in;on	
甥	nephew	
追い込む	to herd;to corner;to drive	
美味しい	delicious;tasty	
追い出す	to expel;to drive out	
於いて	at;in;on	
お出でになる	to be	
老いる	to age;to grow old	
負う	to bear;to owe	
応急	emergency	
黄金	gold	
黄色	yellow	
応募	subscription;application	
おおい	hey!	
大方	perhaps;almost all;majority	
大柄	large build;large pattern	
大げさ	grandiose;exaggerated	
大事	important;valuable;serious matter	
大ざっぱ	rough (as in not precise);broad;sketchy	
大空	heaven;firmament;the sky	
大筋	outline;summary	
大幅	full width;large scale;drastic	
大水	flood	
公	official;public;formal;open;governmental	
お蔭	(your) backing;assistance	
お蔭様で	Thanks to god;thanks to you	
可笑しい	strange;funny;amusing;ridiculous	
犯す	to commit;to perpetrate;to violate;to rape	
侵す	to invade;to raid;to trespass;to violate;to intrude on	
お菜	side dish;accompaniment for rice dishes	
臆病	cowardice;timidity	
遅らす	to retard;to delay	
遅れ	delay;lag	
起こす	to raise;to cause;to wake someone	
行い	deed;conduct;behavior;action;asceticism	
厳か	austere;majestic;dignified;stately;awful;impressive	
傲る	to be proud	
長	chief;head	
押さえる	to stop;to restrain;to seize;to repress;to suppress;to press down	
お先に	before;ahead;previously	
収まる	to be obtained;to end;to settle into;to fit into;to be settled;to be paid;to be delivered	
納まる	to be obtained;to end;to settle into;to fit into;to be settled;to be paid;to be delivered	
治まる	to be at peace;to clamp down;to lessen (storm&nbsp;&nbsp;terror&nbsp;&nbsp;anger)	
お産	(giving) birth	
教え	teachings;precept;lesson;doctrine	
押し込む	to push into;to crowd into	
惜しむ	to be frugal;to value;to regret	
お喋り	chattering;talk;idle talk;chat;chitchat;gossip;chatty;talkative;chatterbox;blabbermouth	
お洒落	smartly dressed;someone smartly dressed;fashion-conscious	
押し寄せる	to push aside;to advance on	
お祖父さん	grandfather;male senior-citizen	
お邪魔します	Excuse me for disturbing (interrupting) you	
雄	male (animal)	
お世辞	flattery;compliment	
襲う	to attack	
遅くとも	at the latest	
恐らく	perhaps	
恐れ	fear;horror	
恐れ入る	to be filled with awe;to feel small;to be amazed;to be surprised;to be disconcerted;to be sorry;to b	
お大事に	Take care of yourself	
煽てる	to stir up;to instigate;to flatter	
落ち込む	to fall into;to feel down (sad)	
落ち着き	calm;composure	
落ち葉	fallen leaves;leaf litter;defoliation;shedding leaves	
落ちる	to fail (e.g. exam);to fall down;to drop	
おっかない	frightening;huge	
仰っしゃる	to say;to speak;to tell;to talk	
乙	1.&nbsp;&nbsp;strange;quaint;stylish;chic;spicy;queer;witty;tasty;romantic; 2.&nbsp;&nbsp;2nd in rank;second sign of the	
お使い	errand	
お手上げ	all over;given in;given up hope;bring to knees	
御手洗い	toilet;restroom;lavatory;bathroom (US)	
弟	younger brother	
落とす	to drop;to lose;to let fall	
訪れる	to visit	
大人しい	obedient;docile;quiet	
少女	daughter;young lady;virgin;maiden;little girl	
お供	attendant;companion	
衰える	to become weak;to decline;to wear;to abate;to decay;to wither;to waste away	
おどおど	coweringly;hesitantly	
脅かす	to threaten;to coerce	
脅す	to threaten;to menace	
驚き	surprise;astonishment;wonder	
同い年	of the same age	
女子	woman;girl	
お願いします	please	
各	each;every;either;respectively;severally	
自ずから	naturally;as a matter of course	
お早う	Good morning	
お祖母さん	grandmother;female senior-citizen	
怯える	to become frightened;to have a nightmare	
夥しい	abundantly;innumerably	
帯びる	to wear;to carry;to be entrusted;to have;to take on;to have a trace of;to be tinged with	
覚え	memory;sense;experience	
御負け	1.&nbsp;&nbsp;a discount;a prize; 2.&nbsp;&nbsp;something additional;bonus;an extra; 3.&nbsp;&nbsp;an exaggeration	
お巡りさん	policeman (friendly term)	
お宮	Shinto shrine	
お襁褓	diaper;nappy	
お目出度う	(ateji) (int) (uk) Congratulations!;an auspicious occasion!	
面	face	
思い付き	plan;idea;suggestion	
面白い	interesting;amusing	
玩具	toy	
重なる	main;principal;important	
趣	meaning;tenor;gist;effect;appearance;taste;grace;charm;refinement	
赴く	to go;to proceed;to repair to;to become	
重役	heavy responsibilities;director	
重んじる	to respect;to honor;to esteem;to prize	
重んずる	to honor;to respect;to esteem;to prize	
お休み	holiday;absence;rest;Good night	
お八	1.&nbsp;&nbsp;(uk) between meal snack;afternoon refreshment;afternoon tea; 2.&nbsp;&nbsp;mid-day snack	
凡そ	about;roughly;as a rule;approximately	
及び	and;as well as	
及ぶ	to reach;to come up to;to amount to;to befall;to happen to;to extend;to match;to equal	
織	weave;weaving;woven item	
檻	cage;pen;jail cell	
折り返す	to turn up;to fold back	
織物	textile;fabric	
織る	to weave	
俺	I (ego) (boastful first-person pronoun)	
愚か	foolish;stupid	
疎か	neglect;negligence;carelessness	
終わる	to finish;to close	
音色	tone color;tone quality;timbre;synthesizer patch	
温和	gentle;mild;moderate	
仮	tentative;provisional	
科	department;section	
個	article counter	
下位	low rank;subordinate;lower order (e.g. byte)	
階	-floor (counter);stories	
改悪	deterioration;changing for the worse	
海運	maritime;marine transportation	
改革	reform;reformation;innovation	
貝殻	shell	
階級	class;rank;grade	
海峡	channel	
会見	interview;audience	
介護	nursing	
開催	holding a meeting;open an exhibition	
回収	collection;recovery	
改修	repair;improvement	
怪獣	monster	
解除	cancellation;rescinding;release;calling off	
回送	forwarding	
階層	class;level;stratum;hierarchy	
開拓	reclamation (of wasteland);cultivation;pioneer	
会談	conversation;conference;discussion;interview	
改定	reform	
改訂	revision	
街道	highway	
介入	intervention	
開発	development;exploitation	
海抜	height above sea level	
介抱	nursing;looking after	
解剖	dissection;autopsy	
回覧	circulation	
海流	ocean current	
改良	improvement;reform	
回路	circuit (electric)	
顧みる	to look back;to turn around;to review	
省みる	to reflect	
返る	to return;to come back;to go back	
顔付き	(outward) looks;features;face;countenance;expression	
掲げる	to publish;to print;to carry (an article);to put up;to hang out;to hoist;to fly (a sail);to float (a	
踵	(shoe) heel	
係り	official;duty;person in charge	
課外	extracurricular	
書き取り	dictation	
書き取る	to write down;to take dictation;to take notes	
掻き回す	to stir up;to churn;to ransack;to disturb	
欠く	to lack;to break;to crack;to chip	
角	1.&nbsp;&nbsp;angle; 2.&nbsp;&nbsp;bishop (shogi)	
核	nucleus;kernel	
格	status;character;case	
佳句	beautiful passage of literature	
画	stroke	
格差	qualitative difference;disparity	
拡散	scattering;diffusion	
各種	every kind;all sorts	
隔週	every other week	
確信	conviction;confidence	
革新	reform;innovation	
確定	definition (math);decision;settlement	
獲得	acquisition;possession	
確保	guarantee;ensure;maintain;insure;secure	
革命	revolution	
確立	establishment	
賭け	betting;gambling;a gamble	
掛け	credit	
駆け足	running fast;double time	
家計	household economy;family finances	
駆けっこ	(foot) race	
駆ける	to run (race&nbsp;&nbsp;esp. horse);to gallop;to canter	
賭ける	to wager;to bet;to risk;to stake;to gamble	
ヶ月	#NAME?	
加工	manufacturing;processing;treatment	
化合	chemical combination	
嵩張る	to be bulky;to be unwieldy;to grow voluminous	
嵩む	to pile up;to increase	
風車	1.&nbsp;&nbsp;windmill; 2.&nbsp;&nbsp;pinwheel	
畏まりました	certainly!	
華奢	luxury;pomp;delicate;slender;gorgeous	
箇所	passage;place;point;part	
火傷	burn;scald	
箇条書き	itemized form;itemization	
噛る	to chew;to bite (at);to gnaw;to nibble;to munch;to crunch;to have a smattering of	
微か	faint;dim;weak;indistinct;hazy;poor;wretched	
霞む	to grow hazy;to be misty	
化する	to change into;to convert into;to transform;to be reduced;to influence;to improve (someone)	
擦る	to touch lightly;to take a percentage (from)	
火星	Mars (planet)	
化石	fossil;petrifaction;fossilization	
河川	rivers	
化繊	synthetic fibres	
過疎	depopulation	
過多	excess;superabundance	
難い	difficult;hard	
片思い	unrequited love	
敵	enemy;rival	
気質	spirit;character;trait;temperament;disposition	
片言	a smattering;talk like a baby;speak haltingly	
片付け	tidying up;finishing	
傾く	to incline toward;to slant;to lurch;to heel over;to be disposed to;to trend toward;to be prone to;to	
傾ける	to incline;to list;to bend;to lean;to tip;to tilt;to slant;to concentrate on;to ruin (a country);to	
固める	to harden;to freeze;to fortify	
偏る	to be one-sided;to incline;to be partial;to be prejudiced;to lean;to be biased	
傍ら	beside(s);while;nearby	
課題	subject;theme;task	
花壇	flower bed	
家畜	domestic animals;livestock;cattle	
画期	epoch-making	
活発	vigor;active	
且つ	yet;and	
割	divide;cut;halve;separate;split;rip;break;crack;smash;dilute	
嘗て	once;ever	
日付	date;dating	
門	gate	
叶う	to come true (wish)	
叶える	to grant (request&nbsp;&nbsp;wish)	
金槌	1.&nbsp;&nbsp;(iron) hammer; 2.&nbsp;&nbsp;punishment	
鉄棒	iron rod;crowbar;horizontal bar (gymnastics)	
可成	considerably;fairly;quite	
加入	becoming a member;joining;entry;admission;subscription;affiliation;adherence;signing	
金庫	safe;vault;treasury;provider of funds	
予言	prediction;promise;prognostication	
兼ねて	simultaneously	
下番	going off duty	
下品	inferior article	
華美	pomp;splendor;gaudiness	
花粉	pollen	
株式	stock (company)	
気触れる	to react to;to be influenced by;to go overboard for	
貨幣	money;currency;coinage	
構え	posture;pose;style	
構える	to set up	
加味	seasoning;flavoring	
噛み切る	to bite off;to gnaw through	
過密	crowded	
瓶	earthenware pot	
かも知れない	may;might;perhaps;may be;possibly	
粥	(rice) gruel	
痒い	itchy;itching	
揶揄う	to ridicule;to tease;to banter with;to make fun of	
身体	the body	
体付き	body build;figure	
絡む	to entangle;to entwine	
借り	borrowing;debt;loan	
下吏	lower official	
加留多	(pt:) (n) playing cards (pt: carta)	
涸れる	to dry up;to run out	
過労	overwork;strain	
辛うじて	barely;narrowly;just manage to do st	
側	side;row;surroundings;part;(watch) case	
可愛い	pretty;cute;lovely;charming;dear;darling;pet	
可愛がる	to love;to be affectionate	
可哀想	poor;pitiable;pathetic	
可愛らしい	lovely;sweet	
交わす	to exchange (messages);to dodge;to parry;to avoid;to turn aside	
代わる	to take the place of;to relieve;to be substituted for;to be exchanged;to change places with;to take	
代わる代わる	alternately	
乾	heaven;emperor	
管	pipe;tube	
幹	(tree) trunk	
冠	crown;diadem;first;best;peerless;cap;naming;designating;initiating on coming of age;top character ra	
観	look;appearance;spectacle	
館	house;hall;building;hotel;inn;guesthouse	
簡易	simplicity;easiness;quasi-	
感慨	strong feelings;deep emotion	
寒気	cold;frost;chill	
簡潔	brevity;conciseness;simplicity	
還元	resolution;reduction;return to origins	
刊行	publication;issue	
慣行	customary practice;habit;traditional event	
勧告	advice;counsel;remonstrance;recommendation	
看護	nursing;(army) nurse	
漢語	Chinese word;Sino-Japanese word	
換算	conversion;change;exchange	
監視	observation;guarding;inspection;surveillance	
慣習	usual (historical) custom	
観衆	spectators;onlookers;members of the audience	
干渉	interference;intervention	
感触	sense of touch;feeling;sensation	
肝心	essential;fundamental;crucial;vital;main	
歓声	cheer;shout of joy	
感染	infection;contagion	
幹線	main line;trunk line	
関税	customs;duty;tariff	
簡素	simplicity;plain	
観点	point of view	
感度	sensitivity;severity (quake)	
幹部	management;(executive) staff;leaders	
勘弁	pardon;forgiveness;forbearance	
完璧	perfection;completeness;flawless	
感無量	deep feeling;inexpressible feeling;filled with emotion	
勧誘	invitation;solicitation;canvassing;inducement;persuasion;encouragement	
関与	participation;taking part in;participating in;being concerned in	
慣用	common;customary	
寛容	forbearance;tolerance;generosity	
観覧	viewing	
官僚	bureaucrat;bureaucracy	
慣例	custom;precedent;of convention	
還暦	60th birthday	
貫禄	presence;dignity	
緩和	relief;mitigation	
蓋	cover;lid;cap	
街	~street;~quarters	
外貨	imported goods;foreign money	
外観	appearance;exterior;facade	
外相	Foreign Minister	
害する	to injure;to damage;to harm;to kill;to hinder	
概説	general statement;outline	
該当	corresponding;answering to;coming under	
街頭	in the street	
概念	general idea;concept;notion	
外来	imported;outpatient clinic	
概略	outline;summary;gist;in brief	
学芸	arts and sciences;liberal arts	
学士	university graduate	
学説	theory	
楽譜	score (music)	
学歴	academic background	
崖	cliff	
雅致	artistry;good taste;elegance;grace	
がっくり	heartbroken	
合唱	chorus;singing in a chorus	
がっしり	firmly;solidly;tough	
合致	agreement;concurrence;conforming to	
がっちり	solidly built;tightly;shrewd;calculating	
月日	(the) date	
合併	combination;union;amalgamation;consolidation;merger;coalition;fusion;annexation;affiliation;incorpor	
がる	feel	
癌	cancer	
眼科	ophthalmology	
眼球	eyeball	
眼鏡	spectacles;glasses	
頑固	stubbornness;obstinacy	
願書	written application or petition	
頑丈	solid;firm;stout;burly;strong;sturdy	
岩石	rock	
元年	first year (of a specific reign)	
贋物	imitation;counterfeit;forgery;sham	
元来	originally;primarily;essentially;logically;naturally	
生	pure;undiluted;raw;crude	
期	period;time	
企画	planning;project	
規格	standard;norm	
着飾る	to dress up	
器官	organ (of body);instrument	
季刊	quarterly (e.g. magazine)	
危害	injury;harm;danger	
気兼ね	hesitance;diffidence;feeling constraint;fear of troubling someone;having scruples about doing someth	
気軽	cheerful;buoyant;lighthearted	
危機	crisis	
聞き取り	listening comprehension	
効き目	effect;virtue;efficacy;impression	
帰京	returning to Tokyo	
基金	fund;foundation	
棄権	abstain from voting;renunciation of a right	
喜劇	comedy;funny show	
起源	origin;beginning;rise	
機構	mechanism;organization	
既婚	marriage;married	
記載	mention;entry	
気障	affectation;conceit;snobbery	
兆し	signs;omen;symptoms	
兆	signs;omen;symptoms	
軋む	to jar;to creak;to grate	
気象	weather;climate	
期日	fixed date;settlement date	
記述	describing;descriptor	
奇数	odd number	
築く	to build;to pile up;to amass	
傷付く	to be hurt;to be wounded;to get injured	
規制	regulation	
汽船	steamship	
寄贈	donation;presentation	
貴族	noble;aristocrat	
鍛える	to forge;to drill;to temper;to train;to discipline	
来る	to come;to arrive;to be due to;to be next;to be forthcoming	
気立て	disposition;nature	
きちっと	exactly;perfectly	
几帳面	methodical;punctual;steady	
切っ掛け	chance;start;cue;excuse;motive;impetus;occasion	
きっかり	exactly;precisely	
喫茶	tea drinking;tea house	
きっちり	precisely;tightly	
屹度	1.&nbsp;&nbsp;(uk) surely;undoubtedly;certainly;without fail; 2.&nbsp;&nbsp;sternly;severely	
きっぱり	clearly;plainly;distinctly	
規定	regulation;provisions	
起点	starting point	
軌道	orbit;railroad track	
甲	1st in rank;first sign of the Chinese calendar;shell;instep;grade A	
気配	indication;market trend;worry	
規範	model;standard;pattern;norm;criterion;example	
気品	aroma	
気風	character;traits;ethos	
起伏	undulation	
規模	scale;scope;plan;structure	
気まぐれ	whim;caprice;whimsy;fickle;moody;uneven temper	
生真面目	too serious;person who is too serious;honesty;sincerity	
期末	end of term	
決まり悪い	feeling awkward;being ashamed	
決まる	to be decided;to be settled;to look good in (clothes)	
記名	signature;register	
脚色	dramatization (e.g. film)	
脚本	scenario	
客観	objective	
規約	agreement;rules;code	
救援	relief;rescue;reinforcement	
休学	temporary absence from school;suspension	
究極	ultimate;final;eventual	
窮屈	narrow;tight;stiff;rigid;uneasy;formal;constrained	
球根	(plant) bulb	
救済	relief;aid;rescue;salvation;help	
給食	school lunch;providing a meal	
給仕	office boy (girl);page;waiter	
休戦	truce;armistice	
旧知	old friend;old friendship	
宮殿	palace	
窮乏	poverty	
丘陵	hill	
共	both;neither (neg);all;and;as well as;including;with;together with;plural ending	
供	offer;present;submit;serve (a meal);supply	
驚異	wonder;miracle	
教員	teaching staff	
教科	subject;curriculum	
協会	association;society;organization	
共感	sympathy;response	
共学	coeducation	
協議	conference;consultation;discussion;negotiation	
教訓	lesson;precept;moral instruction	
境遇	environment;circumstances	
強行	forcing;enforcement	
強硬	firm;vigorous;unbending;unyielding;strong;stubborn	
凶作	bad harvest;poor crop	
共産	communism	
教材	teaching materials	
教習	training;instruction	
郷愁	nostalgia;homesickness	
教職	teaching certificate;the teaching profession	
享受	reception;acceptance;enjoyment;being given	
興じる	to amuse oneself;to make merry	
強制	obligation;coercion;compulsion;enforcement	
共存	coexistence	
姉妹	sisters	
協調	co-operation;conciliation;harmony;firm (market) tone	
協定	arrangement;pact;agreement	
脅迫	threat;menace;coercion;terrorism	
共鳴	resonance;sympathy	
郷里	birth-place;home town	
強烈	strong;intense;severe	
共和	republicanism;cooperation	
曲	tune;piece of music	
局限	limit;localize	
極端	extreme;extremity	
居住	residence	
拒絶	refusal;rejection	
拒否	denial;veto;rejection;refusal	
許容	permission;pardon	
距離	distance;range	
寄与	contribution;service	
清らか	clean;pure;chaste	
気楽	at ease;comfortable	
煌びやか	gorgeous;gaudy;dazzling;gay	
切り	limits;end;bounds;period;place to leave off;closing sentence;all there is;only;since	
桐	paulownia tree	
切り替える	to change;to exchange;to convert;to renew;to throw a switch;to replace;to switch over	
気流	atmospheric current	
奇麗	pretty;clean;nice;tidy;beautiful;fair	
切れ目	break;pause;gap;end;rift;interruption;cut;section;notch;incision;end (of a task)	
際	edge;brink;verge;side	
木綿	cotton	
極めて	exceedingly;extremely	
僅	a little;small quantity	
近眼	nearsightedness;shortsightedness;myopia	
緊急	urgent;pressing;emergency	
近々	nearness;before long	
近郊	suburbs;outskirts	
均衡	equilibrium;balance	
近視	shortsightedness	
禁じる	to prohibit	
禁ずる	to forbid;to suppress	
勤勉	industry;diligence	
勤務	service;duty;work	
禁物	taboo;forbidden thing	
勤労	labor;exertion;diligent service	
議案	legislative bill	
戯曲	play;drama	
議決	resolution;decision;vote	
議事堂	Diet building	
犠牲	sacrifice	
偽造	forgery;falsification;fabrication;counterfeiting	
議題	topic of discussion;agenda	
技能	technical skill;ability;capacity	
逆転	(sudden) change;reversal;turn-around;coming from behind (baseball)	
行	line;row;verse	
業者	trader;merchant	
行政	administration	
業績	achievement;performance;results;work;contribution	
業務	business;affairs;duties;work	
玉	king (shogi)	
漁船	fishing boat	
漁村	fishing village	
義理	duty;sense of duty;honor;decency;courtesy;debt of gratitude;social obligation	
疑惑	doubt;misgivings;distrust;suspicion	
吟味	testing;scrutiny;careful investigation	
区	ward;district;section	
食い違う	to cross each other;to run counter to;to differ;to clash;to go awry	
空腹	hunger	
区画	division;section;compartment;boundary;area;block	
区間	section (of track&nbsp;&nbsp;etc)	
茎	stalk	
区切り	an end;a stop;punctuation	
潜る	1.&nbsp;&nbsp;to drive;to pass through; 2.&nbsp;&nbsp;to evade;to hide; 3.&nbsp;&nbsp;to dive (into or under water);to go undergro	
種々	variety	
嚏	sneeze	
旧事	past events;bygones	
籤引	lottery;drawn lot	
擽ぐったい	ticklish	
草臥れる	to get tired;to wear out	
下らない	good-for-nothing;stupid;trivial;worthless	
件	example;precedent;the usual;the said;the above-mentioned;(man) in question	
口ずさむ	to hum something;to sing to oneself	
嘴	beak;bill	
朽ちる	to rot	
くっきり	distinctly;clearly;boldly	
屈折	bending;indentation;refraction	
くっ付く	to adhere to;to keep close to	
くっ付ける	to attach	
覆す	to overturn;to upset;to overthrow;to undermine	
諄い	verbose;importunate;heavy (taste)	
国境	national or state border	
首飾り	necklace	
首輪	necklace;choker	
組み合わせ	combination	
組み合わせる	to join together;to combine;to join up	
組み込む	to insert;to include;to cut in (printing)	
蔵	warehouse;cellar;magazine;granary;godown;depository;treasury;elevator	
苦しめる	to torment;to harass;to inflict pain	
包む	to be engulfed in;to be enveloped by;to wrap up;to tuck in;to pack;to do up;to cover with;to dress i	
呉れ呉れも	repeatedly;sincerely;earnestly	
呉れる	to give;to let one have;to do for one;to be given	
玄人	expert;professional;geisha;prostitute	
黒字	balance (figure) in the black	
君主	ruler;monarch	
愚痴	idle complaint;grumble	
ぐっと	firmly;fast;much;more	
ぐらい	approximately	
群	group (math)	
軍艦	warship;battleship	
群集	(social) group;crowd;throng;mob;multitude	
軍事	military affairs	
軍備	armaments;military preparations	
軍服	military or naval uniform	
刑	penalty;sentence;punishment	
頃	time;about;toward;approximately (time)	
傾	lean;incline	
系	system;lineage;group	
経過	passage;expiration;progress	
軽快	rhythmical (e.g. melody);casual (e.g. dress);light;nimble	
警戒	warning;admonition;vigilance	
計器	meter;gauge	
契機	opportunity;chance	
敬具	Sincerely yours	
軽減	abatement	
掲載	appearance (e.g. article in paper)	
傾斜	inclination;slant;slope;bevel;list;dip	
形成	formation	
形勢	condition;situation;prospects	
軽率	rash;thoughtless;careless;hasty	
携帯	carrying something	
形態	form;shape;figure	
刑罰	judgement;penalty;punishment	
経費	expenses;cost;outlay	
警部	police inspector	
軽蔑	scorn;disdain	
経歴	personal history;career	
経路	course;route;channel	
汚す	to disgrace;to dishonour	
汚らわしい	filthy;unfair	
汚れ	uncleanness;impurity;disgrace	
汚れる	to get dirty;to become dirty	
獣	beast;brute	
吝嗇	stinginess;miser;miserliness;skinflint;tightwad;niggard;pinching pennies	
結核	tuberculosis;tubercule	
血管	blood vessel	
決行	doing (with resolve);carrying out (i.e. a plan)	
決算	balance sheet;settlement of accounts	
決勝	decision of a contest;finals (in sports)	
結晶	crystal;crystallization	
結成	formation	
結束	union;unity	
傑	excellence	
決意	decision;determination	
決議	resolution;vote;decision	
結合	combination;union	
決断	decision;determination	
欠乏	want;shortage;famine	
蹴飛ばす	to kick away;to kick off;to kick (someone);to refuse;to reject	
貶す	to speak ill of	
煙たい	smoky;feeling awkward	
煙る	to smoke (e.g. fire)	
家来	retainer;retinue;servant	
けれど	but;however	
圏	sphere;circle;range	
権	authority;the right (to do something)	
権威	authority;power;influence	
兼業	side line;second business	
権限	power;authority;jurisdiction	
健在	in good health;well	
懸賞	offering prizes;winning;reward	
検事	public prosecutor	
健全	health;soundness;wholesome	
見地	point of view	
賢明	wisdom;intelligence;prudence	
倹約	thrift;economy;frugality	
兼用	multi-use;combined use;combination;serving two purposes	
権力	power;authority;influence	
劇団	troupe;theatrical company	
激励	encouragement	
月謝	monthly tuition fee	
げっそり	being disheartened;losing weight	
月賦	monthly installment	
下痢	diarrhoea	
原	original;primitive;primary;fundamental;raw	
原形	original form;base form	
現行	present;current;in operation	
原作	original work	
原子	atom	
元首	ruler;sovereign	
原書	original document	
減少	decrease;reduction;decline	
現場	actual spot;scene;scene of the crime	
元素	chemical element	
原則	principle;general rule	
現像	developing (film)	
現地	actual place;local	
限定	limit;restriction	
原点	origin (coordinates);starting point	
原典	original (text)	
減点	subtract;give a demerit	
原爆	atomic bomb	
原文	the text;original	
厳密	strict;close	
原油	crude oil	
言論	discussion	
故	the late (deceased)	
戸	counter for houses	
児	child;the young of animals	
巨	big;large;great	
恋する	to fall in love with;to love	
溝	10^38;hundred undecillion (American);hundred sextillion (British)	
校	-school;proof	
好意	good will;favor;courtesy	
行為	act;deed;conduct	
行員	bank clerk	
交易	trade;commerce	
公演	public performance	
後悔	regret;repentance	
公開	presenting to the public	
航海	sail;voyage	
工学	engineering	
皇居	Imperial Palace	
好況	prosperous conditions;healthy economy	
抗議	protest;objection	
鉱業	mining industry	
興業	industrial enterprise	
高原	tableland;plateau	
煌々と	brilliantly;brightly	
考古学	archaeology	
交互	mutual;reciprocal;alternate	
工作	work;construction;handicraft;maneuvering	
耕作	cultivation;farming	
鉱山	mine (ore)	
講習	short course;training	
交渉	negotiations;discussions;connection	
高尚	high;noble;refined;advanced	
行進	march;parade	
香辛料	spices	
口述	verbal statement	
控除	subsidy;deduction	
向上	elevation;rise;improvement;advancement;progress	
降水	rainfall;precipitation	
洪水	flood	
公然	open (e.g. secret);public;official	
抗争	dispute;resistance	
構想	plan;plot;idea;conception	
拘束	restriction;restraint	
後退	retreat;backspace (BS)	
光沢	brilliance;polish;lustre;glossy finish (of photographs)	
公団	public corporation	
好調	favourable;promising;satisfactory;in good shape	
口頭	oral	
講読	reading;translation	
購読	subscription (e.g. magazine)	
購入	purchase;buy	
公認	official recognition;authorization;licence;accreditation	
光熱費	cost of fuel and light	
荒廃	ruin	
購買	purchase;buy	
好評	popularity;favorable reputation	
交付	delivering;furnishing (with copies)	
降伏	capitulation;surrender;submission	
興奮	excitement;stimulation;agitation;arousal	
公募	public appeal;public contribution	
巧妙	ingenious;skillful;clever;deft	
公用	government business;public use;public expense	
小売	retail	
効率	efficiency	
公立	public (institution)	
小柄	short (build)	
小切手	cheque;check	
国産	domestic products	
国定	state-sponsored;national	
国土	realm	
告白	confession;acknowledgement	
国防	national defence	
国有	national ownership	
国連	U.N.;United Nations	
漕ぐ	to row;to scull;to pedal	
焦げ茶	black tea	
個々	individual;one by one	
箇箇	individual;separate	
心地	feeling;sensation;mood	
心得	knowledge;information	
心掛け	readiness;intention;aim	
心掛ける	to bear in mind;to aim to do	
志	will;intention;motive	
心強い	heartening;reassuring	
志す	to plan;to intend;to aspire to;to set aims (sights on)	
心細い	helpless;forlorn;hopeless;unpromising;lonely;discouraging;disheartening	
試み	trial;experiment	
試みる	to try;to test	
快い	pleasant;agreeable	
凝らす	to freeze;to congeal	
凝る	to congeal;to freeze	
孤児	orphan	
拵える	to make;to manufacture	
拗れる	to get complicated;to grow worse	
故人	the deceased;old friend	
梢	treetop	
個性	individuality;personality;idiosyncrasy	
戸籍	census;family register	
小銭	coins;small change	
固体	solid (body)	
答え	answer;response	
堪える	to bear;to stand;to endure;to put up with;to support;to withstand;to resist;to brave;to be fit for;t	
火燵	table with heater;(orig) charcoal brazier in a floor well	
古代	ancient times	
こだわる	to fuss over;to be particular about;to be concerned about	
誇張	exaggeration	
滑稽	funny;humorous;comical;laughable;ridiculous;joking	
国交	diplomatic relations	
骨董品	curio	
骨	knack;skill	
固定	fixation	
事柄	matter;thing;affair;circumstance	
悉く	altogether;entirely	
言伝	declaration;hearsay	
殊に	especially;above all	
事によると	depending on the circumstances	
孤独	isolation;loneliness;solitude	
粉々	in very small pieces	
此の	this	
この間	the other day;lately;recently	
この頃	recently	
好ましい	nice;likeable;desirable	
個別	particular case	
零す	to spill	
零れる	to overflow;to spill	
細やか	friendly	
混む	to be crowded	
込める	to include;to put into	
篭る	to seclude oneself;to be confined in;to be implied;to be stuffy	
固有	characteristic;tradition;peculiar;inherent;eigen-	
雇用	employment (long term);hire	
暦	calendar;almanac	
孤立	isolation;helplessness	
懲りる	to learn by experience;to be disgusted with	
此れ	this	
此れ等	these	
魂	soul;spirit	
根気	patience;perseverance;energy	
根拠	basis;foundation	
混血	mixed race;mixed parentage	
昆虫	insect;bug	
根底	root;basis;foundation	
混同	confusion;mixing;merger	
今日は	hello;good day (daytime greeting&nbsp;&nbsp;id)	
今晩は	good evening	
根本	origin;source;foundation;root;base;principle	
御	go-;honourable	
語彙	vocabulary;glossary	
濠	moat	
業	Buddhist karma;actions committed in a former life	
号	number;issue	
合意	agreement;consent;mutual understanding	
合議	consultation;conference	
強気	great;grand	
合成	synthesis;composition;synthetic;composite;mixed;combined;compound	
護衛	guard;convoy;escort	
語句	words;phrases	
極楽	paradise	
ご苦労様	Thank you very much for your....	
語源	word root;word derivation;etymology	
誤差	error	
ご座います	to be (polite);to exist	
ご馳走	feast;treating (someone)	
ご馳走さま	feast	
毎	each respectively	
碁盤	Go board	
ご無沙汰	not writing or contacting for a while	
誤魔化す	to deceive;to falsify;to misrepresent	
御免ください	May I come in?	
御免なさい	I beg your pardon;excuse me	
御覧なさい	(please) look;(please) try to do	
佐	help	
再	re-;again;repeated	
差異	difference;disparity	
歳	#NAME?	
再会	another meeting;meeting again;reunion	
災害	calamity;disaster;misfortune	
細菌	bacillus;bacterium;germ	
細工	work;craftsmanship;tactics;trick	
採掘	mining	
採決	vote;roll call	
再建	rebuilding;reconstruction;rehabilitation	
再現	reappearance;reproduction;return;revival	
採算	profit	
採集	collecting;gathering	
再生	playback;regeneration;resuscitation;return to life;rebirth;reincarnation;narrow escape;reclamation;r	
最善	the very best	
採択	adoption;selection;choice	
再発	return;relapse;reoccurrence	
栽培	cultivation	
細胞	cell (biology)	
採用	use;adopt	
遮る	to interrupt;to intercept;to obstruct	
囀る	to sing;to chirp;to twitter	
冴える	to be clear;to be serene;to be cold;to be skillful	
竿	rod;pole (e.g. for drying laundry)	
栄える	to prosper;to flourish	
杯	wine cups	
逆立ち	handstand;headstand	
逆上る	to go back;to go upstream;to make retroactive	
盛る	to prosper;to flourish;to copulate (animals)	
差額	balance;difference;margin	
下がる	to hang down;to abate;to retire;to fall;to step back	
一昨昨日	two days before yesterday	
先に	before;earlier than;ahead;beyond;away;previously;recently	
詐欺	fraud;swindle	
作	a work;a harvest	
策	plan;policy	
柵	fence;paling	
削減	cut;reduction;curtailment	
錯誤	mistake	
作戦	military or naval operations;tactics;strategy	
作物	literary work	
叫び	shout;scream;outcry	
裂ける	to split;to tear;to burst	
捧げる	to lift up;to give;to offer;to consecrate;to devote;to sacrifice;to dedicate	
差し掛かる	to come near to;to approach	
指図	instruction;mandate	
差し出す	to present;to submit;to tender;to hold out	
差し支える	to interfere;to hinder;to become impeded	
差し引く	to deduct	
些事	something small or petty;trifle	
授ける	to grant;to award;to teach	
嘸	I am sure;certainly;no doubt	
定まる	to become settled;to be fixed	
定める	to decide;to establish;to determine	
錯覚	optical illusion;hallucination	
早急	urgent	
察する	to guess;to sense;to presume;to judge;to sympathize with	
さっと	quickly;suddenly	
冊	counter for books	
殺人	murder	
偖	well;now;then	
悟る	to attain enlightenment;to perceive;to understand;to discern	
真実	truth;reality	
裁く	to judge	
錆び	rust (colour)	
左程	(not) very;(not) much	
様	Mr. or Mrs.;manner;kind;appearance	
三味線	three-stringed Japanese guitar;shamisen	
侍	Samurai;warrior	
然も	with gusto;with satisfaction	
作用	action;operation;effect;function	
左様なら	good-bye	
拐う	to carry off;to run away with;to kidnap;to abduct	
爽やか	fresh;refreshing;invigorating;clear;fluent;eloquent	
障る	to hinder;to interfere with;to affect;to do one harm;to be harmful to	
酸	acid	
さん	Mr or Mrs	
酸化	oxidation	
山岳	mountains	
産休	maternity leave	
桟橋	wharf;bridge;jetty;pier	
参議院	House of Councillors	
産後	postpartum;after childbirth	
産出	yield;produce	
参照	reference;consultation;consultation	
参上	calling on;visiting	
賛成	approval;agreement;support;favour	
賛美	praise;adoration;glorification	
産婦人科	maternity and gynecology department	
産物	product;result;fruit	
山腹	hillside;mountainside	
山脈	mountain range	
財	fortune;riches	
財源	source of funds;resources;finances	
在庫	stockpile;stock	
財政	economy;financial affairs	
座談会	symposium;round-table discussion	
雑貨	miscellaneous goods;general goods;sundries	
雑	rough;crude	
雑談	chatting;idle talk	
雑木	various kinds of small trees;assorted trees	
座標	coordinate(s)	
残金	remaining money	
残酷	cruelty;harshness	
残高	(bank) balance;remainder	
死	death;decease	
し	10^24 (kanji is JIS X 0212 kuten 4906);septillion (American);quadrillion (British)	
次	order;sequence;times;next;below	
仕上がり	finish;end;completion	
仕上げ	end;finishing touches;being finished	
仕上げる	to finish up;to complete	
明々後日	two days after tomorrow	
飼育	breeding;raising;rearing	
強いて	by force	
強いる	to force;to compel;to coerce	
仕入れる	to lay in stock;to replenish stock;to procure	
しいんと	silent (as the grave);(deathly) quiet	
歯科	dentistry	
資格	qualifications;requirements;capabilities	
視覚	sense of sight;vision	
仕掛け	device;trick;mechanism;gadget;(small) scale;half finished;commencement;set up;challenge	
仕掛ける	to commence;to lay (mines);to set (traps);to wage (war);to challenge	
然し	however;but	
然しながら	nevertheless;however	
而も	moreover;furthermore;nevertheless;and yet	
市街	urban areas;the streets;town;city	
指揮	command;direction	
色彩	colour;hue;tints	
式場	ceremonial hall;place of ceremony (e.g. marriage)	
為来り	customs	
頻りに	frequently;repeatedly;incessantly;eagerly	
仕切る	to partition;to divide;to mark off;to settle accounts;to toe the mark	
資金	funds;capital	
施行	1.&nbsp;&nbsp;execution;enforcing;carrying out	
しくじる	to fail;to fall through;to blunder	
仕組み	devising;plan;plot;contrivance;construction;arrangement	
死刑	death penalty;capital punishment	
湿気る	to be damp;to be moist	
思考	thought	
志向	intention;aim	
嗜好	taste;liking;preference	
視察	inspection;observation	
資産	property;fortune;means;assets	
刺繍	embroidery	
支持	support;maintenance	
指示	indication;instruction;directions	
雫	drop (of water)	
沈める	to sink;to submerge	
施設	institution;establishment;facility;(army) engineer	
子息	son	
慕う	to yearn for;to miss;to adore;to love dearly	
従って	therefore;consequently;in accordance with	
下心	secret intention;motive	
親しむ	to be intimate with;to befriend	
下調べ	preliminary investigation;preparation	
下地	groundwork;foundation;inclination;aptitude;elementary knowledge of;grounding in;prearrangement;spade	
認める	to write up	
仕立てる	to tailor;to make;to prepare;to train;to send (a messenger)	
下取り	trade in;part exchange	
下火	burning low;waning;declining	
失格	disqualification;elimination;incapacity (legal)	
確り	firmly;tightly;reliable;level-headed;steady	
質素	simplicity;modesty;frugality	
失調	lack of harmony	
嫉妬	jealousy	
尻尾	tail (animal)	
室	room	
質疑	question	
躾	home discipline;training;upbringing;breeding	
仕付ける	to be used to a job;to begin to do;to baste;to tack;to plant	
指摘	pointing out;identification	
視点	opinion;point of view;visual point	
萎びる	to wilt;to fade	
嫋か	supple;flexible;elastic	
屎尿	excreta;raw sewage;human waste;night soil	
凌ぐ	to outdo;to surpass;to endure;to keep out (rain);to stave off;to tide over;to pull through;to defy;t	
始発	first train	
芝	lawn;sod;turf	
屡	often;again and again;frequently	
暫く	little while	
痺れる	to become numb;to go to sleep (i.e.&nbsp;&nbsp;a limb)	
渋い	1.&nbsp;&nbsp;tasteful (clothing);cool;an aura of refined masculinity; 2.&nbsp;&nbsp;astringent;sullen;bitter (taste); 3	
私物	private property;personal effects	
しぶとい	tenacious;stubborn	
司法	administration of justice	
脂肪	fat;grease;blubber	
志望	wish;desire;ambition	
萎む	to wither;to fade (away);to shrivel;to wilt	
仕舞	end;termination;informal (Noh play)	
仕舞う	to finish;to close;to do something completely;to put away;to put an end to	
しまった	Damn it!	
始末	management;dealing;settlement;cleaning up afterwards	
泌み泌み	keenly;deeply;heartily	
染みる	to pierce;to permeate	
使命	mission;errand;message	
締め切り	closing;cut-off;end;deadline;Closed;No Entrance	
僕	manservant;servant (of God)	
社交	social life;social intercourse	
謝絶	refusal	
社宅	company owned house	
吃逆	hiccough;hiccup	
喋る	to talk;to chat;to chatter	
斜面	slope;slanting surface;bevel	
洒落	frank;open-hearted	
洒落る	to joke;to play on words;to dress stylishly	
視野	field of vision;outlook	
種	kind;variety;species	
衆	masses;great number;the people	
周	circuit;lap;circumference;vicinity;Chou (dynasty)	
収益	earnings;proceeds;returns	
修学	learning	
周期	cycle;period	
衆議院	Lower House;House of Representatives	
就業	employment;starting work	
修行	pursuit of knowledge;studying;learning;training;ascetic practice;discipline	
集計	totalization;aggregate	
襲撃	attack;charge;raid	
収支	income and expenditure	
終始	beginning and end;from beginning to end;doing a thing from beginning to end	
修士	Masters degree program	
収集	gathering up;collection;accumulation	
修飾	ornamentation;embellishment;decoration;adornment;polish up (writing);modification (gram)	
終日	all day	
執着	attachment;adhesion;tenacity	
収容	accommodation;reception;seating;housing;custody;admission;entering (in a dictionary)	
修了	completion (of a course)	
守衛	security guard;doorkeeper	
主演	starring;playing the leading part	
主観	subjectivity;subject;ego	
祝賀	celebration;congratulations	
宿命	fate;destiny;predestination	
主権	sovereignty;supremacy;dominion	
手芸	handicrafts	
主催	organization;sponsorship	
取材	choice of subject;collecting data	
趣旨	object;meaning	
主食	staple food	
主人公	protagonist;main character;hero(ine) (of a story);head of household	
主体	subject;main constituent	
主題	subject;theme;motif	
出血	bleeding;haemorrhage	
出産	(child)birth;delivery;production (of goods)	
出社	arrival (in a country&nbsp;&nbsp;at work&nbsp;&nbsp;etc.)	
出生	birth	
出世	promotion;successful career;eminence	
出費	expenses;disbursements	
出品	exhibit;display	
出演	performance;stage appearance	
出題	proposing a question	
出動	sailing;marching;going out	
主導	main leadership	
主任	person in charge;responsible official	
首脳	head;brains	
守備	defense	
手法	technique	
私有	private ownership	
諸	various;many;several	
背負う	to be burdened with;to carry on back or shoulder	
象	phenomenon	
症	illness	
傷	wound;injury;hurt;cut;gash;bruise;scratch;scar;weak point	
商	quotient	
消去	elimination;erasing;dying out;melting away	
衝撃	shock;crash;impact;ballistic	
証言	evidence;testimony	
証拠	evidence;proof	
消耗	exhaustion;consumption	
照合	collation;comparison	
詳細	detail;particulars	
昇進	promotion	
少数	minority;few	
称する	to pretend;to take the name of;to feign;to purport	
消息	news;letter;circumstances	
承諾	consent;acquiescence;agreement	
象徴	symbol	
小児科	pediatrics	
証人	witness	
照明	illumination	
勝利	victory;triumph;conquest;success;win	
奨励	encouragement;promotion;message;address	
職員	staff member;personnel	
植民地	colony	
職務	professional duties	
諸君	Gentlemen!;Ladies!	
所在	whereabouts	
所々	here and there;some parts (of something)	
所持	possession;owning	
所属	attached to;belong to	
処置	treatment	
しょっちゅう	always;constantly	
所定	fixed;prescribed	
所得	income;earnings	
初版	first edition	
処罰	punishment	
書評	book review	
処分	disposal;dealing;punishment	
庶民	masses;common people	
庶務	general affairs	
私用	personal use;private business	
仕様	way;method;resource;remedy;(technical) specification	
使用人	employee;servant	
調べ	preparation;investigation;inspection	
知り合い	acquaintance	
退く	to retreat;to recede;to withdraw	
退ける	to repel;to drive away	
記す	to note;to write down	
指令	orders;instructions;directive	
代	price;materials;substitution	
皺	wrinkles;creases	
新	new	
進化	evolution;progress	
殿	rear;rear unit guard	
審議	deliberation	
進行	advance	
新興	rising;developing;emergent	
振興	promotion;encouragement	
申告	report;statement;filing a return;notification	
新婚	newly-wed	
審査	judging;inspection;examination;investigation	
紳士	gentleman	
進出	advance;step forward	
信者	believer;adherent;devotee;Christian	
真珠	pearl	
心中	double suicide;lovers suicide	
心情	mentality	
新人	new face;newcomer	
神聖	holiness;sacredness;dignity	
親善	friendship	
真相	truth;real situation	
新築	new building;new construction	
進呈	presentation	
進展	progress;development	
神殿	temple;sacred place	
進度	progress	
振動	oscillation;vibration	
新入生	freshman;first-year student	
信任	trust;confidence;credence	
審判	refereeing;trial;judgement;umpire;referee	
神秘	mystery	
辛抱	patience;endurance	
真理	truth	
侵略	aggression;invasion;raid	
診療	medical examination and treatment;diagnosis	
進路	course;route	
自覚	self-conscious	
地方	area;locality;district;region;the coast	
自我	self;the ego	
磁気	magnetism	
磁器	porcelain;china	
事業	project;enterprise;business;industry;operations	
地形	terrain;geographical features;topography	
軸	axis;stem;shaft;axle	
自己	self;oneself	
事項	matter;item;facts	
時刻表	table;diagram;chart;timetable;schedule	
地獄	hell	
時差	time difference	
自在	freely;at will	
自主	independence;autonomy	
自首	surrender;give oneself up	
辞職	resignation	
自信	self-confidence	
事前	prior;beforehand;in advance	
自尊心	self-respect;conceit	
持続	continuation	
字体	type;font;lettering	
辞退	refusal	
じっくり	deliberately;carefully	
実質	substance;essence	
実践	practice;put into practice	
実態	truth;fact	
実費	actual expense;cost price	
十分	10 minutes	
実	truth;reality;sincerity;fidelity;kindness;faith;substance;essence	
実業家	industrialist;businessman	
実情	real condition;actual circumstances;actual state of affairs	
自転	rotation;spin	
自動詞	intransitive verb (no direct obj)	
地主	landlord	
耳鼻科	otolaryngology	
地元	local	
弱	weakness;the weak;little less then	
若干	some;few;number of	
砂利	gravel;ballast;pebbles	
じゃん拳	rock-scissors-paper game	
住	dwelling;living	
従業員	employee;worker	
従事	engaging;pursuing;following	
充実	fullness;completion;perfection;substantiality;enrichment	
十字路	crossroads	
絨毯	carpet	
柔軟	flexible;lithe	
重複	duplication;repetition;overlapping;redundancy;restoration	
重宝	priceless treasure;convenience;usefulness	
従来	up to now;so far;traditional	
塾	coaching school;lessons	
樹木	trees and shrubs;arbour	
樹立	establish;create	
準急	local express (train&nbsp;&nbsp;slower than an express)	
準じる	to follow;to conform;to apply to	
準ずる	to apply correspondingly;to correspond to;to be proportionate to;to conform to	
助	help;rescue;assistant	
情	feelings;emotion;passion	
畳	#NAME?	
尉	jailer;old man;rank;company officer	
嬢	young woman	
状	shape	
上位	superior (rank not class);higher order (e.g. byte);host computer (of connected device)	
上演	performance (e.g. music)	
城下	land near the castle	
乗客	passenger	
上空	sky;the skies;high-altitude sky;upper air	
上司	superior authorities;boss	
情緒	emotion;feeling	
上昇	rising;ascending;climbing	
情勢	state of things;condition;situation	
情熱	passion;enthusiasm;zeal	
丈夫	1.&nbsp;&nbsp;hero;gentleman;warrior;manly person; 2.&nbsp;&nbsp;good health;robustness;strong;solid;durable	
譲歩	concession;conciliation;compromise	
条約	treaty;pact	
上陸	landing;disembarkation	
蒸留	distillation	
除外	exception;exclusion	
助言	advice;suggestion	
徐行	going slowly	
女史	Ms.	
助詞	particle;postposition	
助動詞	auxiliary verb	
自立	independence;self-reliance	
人	man;person;people	
人格	personality;character;individuality	
人材	man of talent	
迅速	quick;fast;rapid;swift;prompt	
人体	human body	
人民	people;public	
人目	glimpse;public gaze	
水気	1.&nbsp;&nbsp;moisture;dampness;vapor; 2.&nbsp;&nbsp;dropsy;edema	
水源	source of river;fountainhead	
推進	propulsion;driving force	
水洗	flushing	
吹奏	playing wind instruments	
推測	guess;conjecture	
水田	(water-filled) paddy field	
推理	reasoning;inference;mystery or detective genre (movie&nbsp;&nbsp;novel&nbsp;&nbsp;etc.)	
数詞	numeral	
崇拝	worship;adoration;admiration;cult	
据え付ける	to install;to equip;to mount	
据える	to set (table);to lay (foundation);to place (gun);to apply (moxa)	
清々しい	fresh;refreshing	
過ぎ	past;after	
救い	help;aid;relief	
掬う	to scoop;to ladle out	
少なくとも	at least	
直ぐ	immediately;soon;easily;right (near);honest;upright	
健やか	vigorous;healthy;sound	
濯ぐ	to rinse;to wash out	
進み	progress	
勧め	recommendation;advice;encouragement	
裾	(trouser) cuff;(skirt) hem;cut edge of a hairdo;foot of mountain	
廃れる	to go out of use;to become obsolete;to die out;to go out of fashion	
酸っぱい	sour;acid	
素敵	lovely;dreamy;beautiful;great;fantastic;superb;cool;capital	
即ち	that is;namely;i.e.	
すばしこい	nimble;smart;quick	
素早い	fast;quick;prompt;agile	
済ます	to finish;to get it over with;to settle;to conclude;to pay back	
澄ます	to clear;to make clear;to be unruffled;to look unconcerned;to look demure;look prim;put on airs	
済まない	sorry (phrase)	
済みません	sorry;excuse me	
天皇	Emperor of Japan	
刷り	printing	
剃る	to shave	
擦れ違い	chance encounter	
すれ違う	to pass by one another;to disagree;to miss each other	
擦れる	to rub;to chafe;to wear;to become sophisticated	
すんなり	pass with no objection;slim;slender	
図々しい	impudent;shameless	
ずばり	decisively;decidedly;once and for all;unreservedly;frankly	
ずぶ濡れ	soaked;dripping wet	
ずらっと	in a line;in a row	
ずるずる	sound or act of dragging;loose;inconclusive but unwanted situation;trailingly	
ずれ	gap;slippage	
ずれる	to slide;to slip off	
制	system;organization;imperial command;laws;regulation;control;government;suppression;restraint;holdin	
製	-made;make	
生育	growth;development;breeding	
成果	results;fruits	
正解	correct;right;correct interpretation (answer&nbsp;&nbsp;solution)	
正規	regular;legal;formal;established;legitimate	
正義	justice;right;righteousness;correct meaning	
生計	livelihood;living	
政権	administration;political power	
精巧	elaborate;delicate;exquisite	
制裁	restraint;sanctions;punishment	
政策	political measures;policy	
清算	liquidation;settlement	
星座	constellation	
生死	life and death	
静止	stillness;repose;standing still	
青春	youth;springtime of life;adolescent	
聖書	Bible;scriptures	
誠実	sincere;honest;faithful	
成熟	maturity;ripeness	
清純	purity;innocence	
正常	normalcy;normality;normal	
制する	to control;to command;to get the better of	
整然	orderly;regular;well-organized;trim;accurate	
盛装	be dressed up;wear rich clothes	
盛大	grand;prosperous;magnificent	
清濁	good and evil;purity and impurity	
制定	enactment;establishment;creation	
静的	static	
製鉄	iron manufacture	
晴天	fine weather	
正当	just;justifiable;right;due;proper;equitable;reasonable;legitimate;lawful	
成年	majority;adult age	
制服	uniform	
征服	conquest;subjugation;overcoming	
製法	manufacturing method;recipe;formula	
精密	precise;exact;detailed;minute;close	
声明	declaration;statement;proclamation	
姓名	full name	
制約	limitation;restriction;condition;constraints	
生理	physiology;menses	
勢力	influence;power;might;strength;potency;force;energy	
整列	stand in a row;form a line	
急かす	to hurry;to urge on	
伜	son;my son	
責務	duty;obligation	
世辞	flattery;compliment	
世帯	household	
世代	generation;the world;the age	
切開	clearing (land);opening up;cutting through	
接触	touch;contact	
設置	establishment;institution	
折衷	compromise;cross;blending;eclecticism	
設定	establishment;creation	
説得	persuasion	
節	node;section;occasion;time	
切実	compelling;serious;severe;acute;earnest;pressing;urgent	
接続詞	conjunction	
切ない	painful;trying;oppressive;suffocating	
設立	establishment;foundation;institution	
攻め	attack;offence	
世論	public opinion	
仙	hermit;wizard	
前	before	
繊維	fibre;fiber;textile	
選挙	election	
宣教	religious mission	
宣言	declaration;proclamation;announcement	
先行	preceding;going first	
選考	selection;screening	
戦災	war damage	
専修	specialization	
戦術	tactics	
潜水	diving	
先先月	month before last	
先先週	week before last	
先代	family predecessor;previous age;previous generation	
先だって	recently;the other day	
先着	first arrival	
先天的	a priori;inborn;innate;inherent;congenital;hereditary	
戦闘	battle;fight;combat	
潜入	infiltration;sneaking in	
船舶	ship	
専用	exclusive use;personal use	
占領	occupation;capture;possession;have a room to oneself	
戦力	war potential	
税務署	tax office	
是正	correction;revision	
絶版	out of print	
絶望	despair;hopelessness	
是非とも	by all means (with sense of not taking no for an answer)	
膳	(small) table;tray;meal	
禅	Zen (Buddhism)	
全快	complete recovery of health	
全盛	height of prosperity	
前提	preamble;premise;reason;prerequisite	
前途	future prospects;outlook;the journey ahead	
全滅	annihilation	
善良	goodness;excellence;virtue	
前例	precedent	
僧	monk;priest	
沿う	to run along;to follow	
添う	to accompany;to become married;to comply with	
総	whole;all;general;gross	
相応	suitability;fitness	
総会	general meeting	
創刊	launching (e.g. newspaper);first issue	
送金	remittance;sending money	
走行	running a wheeled vehicle (e.g. car);traveling	
総合	synthesis;coordination;putting together;integration;composite	
捜査	search (esp. in criminal investigations);investigation	
捜索	search (esp. for someone or something missing);investigation	
然うして	and;like that	
装飾	ornament	
操縦	management;handling;control;manipulation	
創造	creation	
壮大	magnificent;grand;majestic;splendid	
騒動	strife;riot;rebellion	
遭難	disaster;shipwreck;accident	
相場	market price;speculation;estimation	
装備	equipment	
創立	establishment;founding;organization	
添える	to add to;to attach;to append;to accompany;to garnish;to imitate;to annex	
即座に	immediately;right away	
促進	promotion;acceleration;encouragement;facilitation;spurring on	
即する	to conform to;to agree with;to be adapted to;to be based on	
束縛	restraint;shackles;restriction;confinement;binding	
側面	side;flank;sidelight;lateral	
其処	that place;there	
其処で	so (conj);accordingly;now;then;thereupon	
損なう	to harm;to hurt;to injure;to damage;to fail in doing	
其処ら	everywhere;somewhere;approximately;that area;around there	
素材	raw materials;subject matter	
阻止	obstruction;check;hindrance;prevention;interdiction	
然して	and	
訴訟	litigation;lawsuit	
育ち	breeding;growth	
措置	measure;step	
其方	over there;the other	
素っ気ない	cold;short;curt;blunt	
率直	frankness;candour;openheartedness	
外方	look (or turn) the other way	
備え付ける	to provide;to furnish;to equip;to install	
備わる	to be furnished with;to be endowed with;to possess;to be among;to be one of;to be possessed of	
その上	in addition;furthermore	
その内	eventually;sooner or later;of the previously mentioned	
その為	hence;for that reason	
その外	besides;in addition;the rest	
其の儘	without change;as it is (i.e. now)	
聳える	to rise;to tower;to soar	
素朴	simplicity;artlessness;naivete	
染まる	to dye	
背く	to run counter to;to go against;to disobey;to infringe	
染める	to dye;to colour	
逸らす	to turn away;to avert	
反り	warp;curvature;curve;arch	
其れ	it;that	
其れから	and then;after that	
各々	each;every;either;respectively;severally	
其れで	and (conj);thereupon;because of that	
其れでは	in that situation;well then ...	
其れでも	but (still);and yet;nevertheless;even so;notwithstanding	
其れ共	or;or else	
其れに	besides;moreover	
其れ程	to that degree;extent	
其れ故	therefore;for that reason;so	
揃い	set;suit;uniform	
徐々	gradually;steadily;quietly;slowly;soon	
損失	loss	
存続	duration;continuance	
沿い	along	
像	statue;image;figure;picture;portrait	
増強	augment;reinforce;increase	
蔵相	Minister of Finance	
増進	promoting;increase;advance	
ぞんざい	rude;careless;slovenly	
他意	ill will;malice;another intention;secret purpose;ulterior motive;fickleness;double-mindedness	
退化	degeneration;retrogression	
対応	interaction;correspondence;coping with;dealing with	
体格	physique;constitution	
退学	dropping out of school	
大概	in general;mainly	
大金	great cost	
待遇	treatment;reception	
対決	confrontation;showdown	
体験	personal experience	
対抗	opposition;antagonism	
対して	for;in regard to;per	
大衆	general public	
対処	deal with;cope	
退職	retirement (from office)	
退治	extermination	
態勢	attitude;conditions;preparations	
対談	talk;dialogue;conversation	
対等	equivalent	
滞納	non-payment;default	
対比	contrast;comparison	
大部	most (e.g. most part);greater;fairly;a good deal;much	
対辺	(geometrical) opposite side	
待望	expectant waiting	
怠慢	negligence;procrastination;carelessness	
対面	interview;meeting	
対立	confrontation;opposition;antagonism	
体力	physical strength	
対話	interactive;interaction;conversation;dialogue	
耐える	to bear;to endure	
絶える	to die out;to peter out;to become extinct	
高	quantity;amount;volume;number;amount of money	
高まる	to rise;to swell;to be promoted	
焚火	(open) fire	
沢山	many;a lot;much	
逞しい	burly;strong;sturdy	
巧み	skill;cleverness	
類	a kind	
丈	height;stature;length;measure;all (one has)	
足し算	addition	
多数決	majority rule	
助け	assistance	
携わる	to participate;to take part	
漂う	to drift about;to float;to hang in air	
立方	dancing (geisha)	
忽ち	at once;in a moment;suddenly;all at once	
立ち寄る	to stop by;to drop in for a short visit	
達者	skillful;in good health	
達成	achievement	
たった	only;merely;but;no more than	
尊い	precious;valuable;priceless;noble;exalted;sacred	
貴い	precious;valuable;priceless;noble;exalted;sacred	
尊ぶ	to value;to prize;to esteem	
絶つ	to sever;to cut off;to suppress;to abstain (from)	
盾	shield;buckler;escutcheon;pretext	
建前	face;official stance;public position or attitude (as opposed to private thoughts)	
奉る	to offer;to present;to revere;to do respectfully	
例え	example;even if;if;though;although	
仮令	example;even if;if;though;although	
他動詞	transitive verb (direct obj)	
辿り着く	to grope along to;to struggle on to;to arrive somewhere after a struggle	
辿る	to follow (road);to pursue (course);to follow up	
掌	the palm	
楽しむ	to enjoy oneself	
頼み	request;favor;reliance;dependence	
煙草	(pt:) (n) (uk) tobacco (pt: tabaco);cigarettes	
度々	often;repeatedly;frequently	
他方	another side;different direction;(on) the other hand	
多忙	busy;pressure of work	
給う	to receive;to grant	
偶に	occasionally;once in a while	
堪らない	intolerable;unbearable;unendurable	
溜まり	collected things;gathering place;arrears	
賜る	to grant;to bestow	
例	instance;example;case;precedent;experience;custom;usage;parallel;illustration	
躊躇う	to hesitate	
保つ	to keep;to preserve;to hold;to retain;to maintain;to support;to sustain;to last;to endure;to keep we	
容易い	easy;simple;light	
多様	diversity;variety	
弛み	slack;slackening;dullness;letdown	
弛む	to slacken;to loosen;to relax	
誰	adjectival suffix for a person	
垂れる	to hang;to droop;to drop;to lower;to pull down;to dangle;to sag;to drip;to ooze;to trickle;to leave	
歎	grief;sigh;lamentation	
反	roll of cloth (c. 10 yds.);.245 acres;300 tsubo	
単一	single;simple;sole;individual;unitory	
短歌	tanka;31-syllable Japanese poem	
担架	stretcher;litter	
短気	quick temper	
探検	exploration;expedition	
短縮	shortening;abbreviation;reduction	
箪笥	chest of drawers	
炭素	carbon (C)	
短大	junior college	
単調	monotony;monotone;dullness	
単独	sole;independence;single;solo (flight)	
短波	short wave	
蛋白質	protein	
第	ordinal	
第一	first;foremost;# 1	
大胆	bold;daring;audacious	
台無し	mess;spoiled;(come to) nothing	
大便	feces;excrement;shit	
代弁	pay by proxy;act for another;speak for another	
台本	libretto;scenario	
代用	substitution	
打開	break in the deadlock	
妥協	compromise;giving in	
妥結	agreement	
打撃	1.&nbsp;&nbsp;blow;shock;strike;damage; 2.&nbsp;&nbsp;batting (baseball)	
駄作	poor work;rubbish	
脱出	escape	
脱する	to escape from;to get out	
脱退	secession	
だぶだぶ	loose;baggy	
騙す	to trick;to cheat;to deceive	
だらけ	implying (negatively) that something is full of&nbsp;&nbsp;e.g. mistakes	
怠い	sluggish;feel heavy;languid;dull	
壇	1.&nbsp;&nbsp;platform;podium;rostrum; 2.&nbsp;&nbsp;(arch) mandala	
団結	unity;union;combination	
断言	declaration;affirmation	
断然	firmly;absolutely;definitely	
段々	gradually;by degrees	
旦那	master (of house);husband (informal)	
断面	cross section	
弾力	elasticity;flexibility	
治安	public order	
近付く	to approach;to get near;to get acquainted with;to get closer	
違える	to change	
契る	to pledge;to promise;to swear	
畜産	animal husbandry	
畜生	beast;brute;damn	
蓄積	accumulation;accumulate;store	
知性	intelligence	
乳	milk;breast;loop	
父母	father and mother;parents	
縮まる	to be shortened;to be contracted;to shrink	
窒息	suffocation	
些とも	not at all (neg. verb)	
秩序	order;regularity;system;method	
知的	intellectual	
著	counter for suits of clothing;arriving at ..	
着	counter for suits of clothing;arriving at ..	
着手	embarkation;launch	
着色	colouring;coloring	
着席	sit down;seat	
着目	attention	
着陸	landing;alighting;touch down	
着工	start of (construction) work	
茶の間	living room (Japanese style)	
茶の湯	tea ceremony	
ちやほや	pamper;make a fuss of;spoil	
昼間	daytime;during the day	
宙返り	somersault;looping-the-loop	
中継	relay;hook-up	
忠告	advice;warning	
中指	middle finger	
中傷	slander;libel;defamation	
忠実	fidelity;faithfulness	
中枢	centre;pivot;mainstay;nucleus;backbone;central figure;pillar;key man	
抽選	lottery;raffle;drawing (of lots)	
中断	interruption;suspension;break	
中腹	irritated;offended	
中毒	poisoning	
仲人	go-between;matchmaker	
昼飯	lunch;midday meal	
中立	neutrality	
中和	neutralize;counteract	
腸	guts;bowels;intestines	
蝶	butterfly	
超	super-;ultra-;hyper-	
庁	government office	
調印	signature;sign;sealing	
聴覚	the sense of hearing	
長官	chief;(government) secretary	
聴講	lecture attendance;auditing	
徴収	collection;levy	
聴診器	stethoscope	
挑戦	challenge;defiance	
長大	very long;great length	
調停	arbitration;conciliation;mediation	
恰度	just;right;exactly	
長編	long (e.g. novel&nbsp;&nbsp;film)	
丁目	district of a town;city block (of irregular size)	
調理	cooking	
調和	harmony	
ちょくちょく	often;frequently;now and then;occasionally	
直面	confrontation	
著書	literary work;book	
貯蓄	savings	
直感	intuition	
一寸	(ateji) (adv int) (uk) just a minute;a short time;a while;just a little;somewhat;easily;readily;rath	
著名	well-known;noted;celebrated	
ちらっと	at a glance;by accident	
塵取り	dustpan	
治療	medical treatment	
賃金	wages	
沈殿	precipitation;settlement	
沈没	sinking;foundering	
沈黙	silence;reticence	
陳列	exhibition;display;show	
追及	gaining on;carrying out;solving (crime)	
追跡	pursuit	
次いで	next;secondly;subsequently	
追放	exile;banishment	
費やす	to spend;to devote;to waste	
墜落	falling;crashing	
通	connoisseur;counter for letters	
痛感	feeling keenly;fully realizing	
通常	common;general;usually	
痛切	keen;acute	
杖	cane	
遣い	mission;simple task;doing	
使い道	use	
仕える	to serve;to work for	
司る	to rule;to govern;to administer	
束の間	moment;brief time;brief;transient	
付き	attached to;impression;sociality;appearance;furnished with;under;to	
付き合う	to associate with;to keep company with;to get on with	
月並み	every month;common	
尽きる	to be used up;to be run out;to be exhausted;to be consumed;to come to an end	
継ぎ目	a joint;joining point	
吐く	1.&nbsp;&nbsp;to breathe; 2.&nbsp;&nbsp;to tell (lies); 3.&nbsp;&nbsp;to vomit;to disgorge	
尽くす	to exhaust;to run out;to serve (a person);to befriend	
作り	make-up;sliced raw fish	
造り	make up;structure;physique	
造る	to make;to create;to manufacture;to draw up;to write;to compose;to build;to coin;to cultivate;to org	
繕う	to mend;to repair;to fix;to patch up;to darn;to tidy up;to adjust;to trim	
接ぐ	to join;to piece together;to set (bones);to graft (trees)	
継ぐ	to succeed	
付け加える	to add one thing to another	
告げる	to inform	
辻褄	coherence;consistency	
途中	on the way;en route	
突っ張る	to support;to become stiff;to become taut;to thrust (ones opponent);to stick to (ones opinion);to in	
筒	pipe;tube	
銃	gun	
突く	1.&nbsp;&nbsp;to thrust;to strike;to attack; 2.&nbsp;&nbsp;to poke;to nudge;to pick at	
慎む	to be careful;to be chaste or discreet;to abstain or refrain	
伝言	verbal message;rumor;word	
勤まる	to be fit for;to be equal to;to function properly	
勤め先	place of work	
努めて	make an effort!;work hard!	
津波	tsunami;tidal wave	
抓る	to pinch	
募る	to invite;to solicit help&nbsp;&nbsp;participation&nbsp;&nbsp;etc	
唾	saliva;sputum	
呟く	to mutter;to murmur	
瞑る	to close the eyes	
壷	tsubo jar;pot;vase	
蕾	bud;flower bud	
躓く	to stumble;to trip	
摘む	to pinch;to hold;to pick up	
詰らない	insignificant;boring;trifling	
詰まり	in short;in brief;in other words;that is to say;in the long run;after all;blockade;stuffing;ultimate	
積もり	intention;plan	
露	dew	
強まる	to get strong;to gain strength	
強める	to strengthen;to emphasize	
連なる	to extend;to stretch out;to stand in a row	
貫く	to go through	
連ねる	to link;to join;to put together	
釣り	fishing;angling	
吊り革	strap	
釣鐘	hanging bell	
吊るす	to hang	
手当て	allowance;compensation;treatment;medical care	
体	appearance;air;condition;state;form	
提供	offer;tender;program sponsoring;furnishing	
定義	definition	
提携	cooperation;tie-up;joint business;link-up	
体裁	decency;style;form;appearance;show;get-up;format	
梯子	ladder;stairs	
定食	set meal;special (of the day)	
提示	presentation;exhibit;suggest;citation	
訂正	correction;revision	
停滞	stagnation;tie-up;congestion;retention;accumulation;falling into arrears	
邸宅	mansion;residence	
定年	retirement age	
堤防	bank;weir	
手遅れ	too late;belated treatment	
手数	number of moves;trouble	
手掛かり	contact;trail;scent;on hand;hand hold;clue;key	
手掛ける	to handle;to manage;to work with;to rear;to look after;to have experience with	
手軽	easy;simple;informal;offhand;cheap	
的	-like;typical	
適応	adaptation;accommodation;conformity	
適宜	suitability	
適性	aptitude	
手際	performance;skill;tact	
手順	process;procedure;protocol	
手錠	handcuffs;manacles	
手近	near;handy;familiar	
てっきり	surely;certainly;beyond doubt	
鉄鋼	iron and steel	
徹する	to sink in;to penetrate;to devote oneself;to believe in;to go through;to do intently and exclusively	
鉄片	iron scraps	
手配	arrangement;search (by police)	
手筈	arrangement;plan;programme	
手引き	guidance;guide;introduction	
手本	model;pattern	
手回し	preparations;arrangements	
手元	on hand;at hand;at home	
照り返す	to reflect;to throw back light	
手分け	division of labour	
店	store;shop;establishment	
点火	ignition;lighting;set fire to	
転回	revolution;rotation	
転換	convert;divert	
転居	moving;changing residence	
転勤	transfer;transmission	
点検	inspection;examination;checking	
転校	change schools	
天国	paradise;heaven;Kingdom of Heaven	
天才	genius;prodigy;natural gift	
天災	natural calamity;disaster	
展示	exhibition;display	
天井	ceiling;ceiling price	
転じる	to turn;to shift;to alter;to distract	
点線	dotted line;perforated line	
天体	heavenly body	
転転	rolling about;moving from place to place;being passed around repeatedly	
てんで	(not) at all;altogether;entirely	
転任	change of post	
展望	view;outlook;prospect	
転落	fall;degradation;slump	
出合う	to meet by chance;to come across;to happen to encounter;to hold a rendezvous;to have a date	
出入り口	exit and entrance	
でかい	huge	
出来物	able man;tumour;growth;boil;ulcer;abcess;rash;pimple	
出切る	to be out of;to have no more at hand	
出くわす	to happen to meet;to come across	
出鱈目	irresponsible utterance;nonsense;nonsensical;random;haphazard;unsystematic	
出直し	adjustment;touch up	
田園	country;rural districts	
電源	source of electricity;power (button on TV&nbsp;&nbsp;etc.)	
伝説	tradition;legend;folklore	
電線	electric line	
伝達	transmission (e.g. news);communication;delivery	
伝来	ancestral;hereditary;imported;transmitted;handed down	
と	1.&nbsp;&nbsp;if (conjunction); 2.&nbsp;&nbsp;promoted pawn (shogi) (abbr)	
問い合わせる	to enquire;to seek information	
問屋	wholesale store	
問う	to ask;to question;to charge (i.e. with a crime);to accuse;without regard to (neg)	
棟	place;section;building	
等	et cetera;etc.;and the like	
陶器	pottery;ceramics	
等級	grade;class	
討議	debate;discussion	
登校	attendance (at school)	
統合	integration;unification;synthesis	
倒産	(corporate) bankruptcy;insolvency	
投資	investment	
統治	rule;reign;government;governing	
統制	regulation;control	
当選	being elected;winning the prize	
逃走	flight;desertion;escape	
統率	command;lead;generalship;leadership	
到達	reaching;attaining;arrival	
到底	(cannot) possibly	
丁々	clashing of swords;felling of trees;ringing of an ax	
投入	throw;investment;making (an electrical circuit)	
当人	the one concerned;the said person	
逃亡	escape	
冬眠	hibernation;winter sleep	
登録	registration;register;entry;record	
討論	debate;discussion	
遠ざかる	to go far off	
遠回り	detour;roundabout way	
通りかかる	to happen to pass by	
兎角	anyhow;anyway;somehow or other;generally speaking;in any case;this and that;many;be apt to	
咎める	to blame;to find fault;to take someone to task;to aggravate (an injury)	
時折	sometimes	
跡切れる	to pause;to be interrupted	
説く	to explain;to advocate;to preach;to persuade	
特技	special skill	
特産	specialty;special product	
特集	feature (e.g. newspaper);special edition;report	
得点	score;points made;marks obtained;runs	
特派	send specially;special envoy	
特有	characteristic (of);peculiar (to)	
研ぐ	to sharpen;to grind;to scour;to hone;to polish;to wash (rice)	
刺	thorn;splinter;spine;biting words	
遂げる	to accomplish;to achieve;to carry out	
床	bed;sickbed;alcove;padding	
所が	however;while;even if	
所で	by the way;even if;no matter what	
年頃	age;marriageable age;age of puberty;adolescence;for some years	
年寄り	old people;the aged	
戸締り	closing up;fastening the doors	
途上	en route;half way	
綴じる	to bind;to file	
途絶える	to stop;to cease;to come to an end	
特許	special permission;patent	
疾っくに	long ago;already;a long time ago	
特権	privilege;special right	
咄嗟	moment;instant	
取っ手	handle;grip;knob	
突破	breaking through;breakthrough;penetration	
突如	suddenly;all of a sudden	
迚も	very;awfully;exceedingly	
整える	to put in order;to get ready;to arrange;to adjust	
届け	report;notification;registration	
滞る	to stagnate;to be delayed	
止まる	to be limited to	
留める	to stop;to cease;to put an end to	
止める	to stop;to cease;to put an end to	
唱える	to recite;to chant;to call upon	
兎に角	anyhow;at any rate;anyway;somehow or other;generally speaking;in any case	
殿様	feudal lord	
幕	curtain;bunting;act (in play)	
帳	curtain	
扉	door;opening	
徒歩	walking;going on foot	
乏しい	meagre;scarce;limited;destitute;hard up;scanty;poor	
富	wealth;fortune	
富む	to be rich;to become rich	
兎も角	anyhow;anyway;somehow or other;generally speaking;in any case	
共稼ぎ	working together;(husband and wife) earning a living together	
灯	light	
伴う	to accompany;to bring with;to be accompanied by;to be involved in	
共働き	dual income	
捕らえる	to seize;to grasp;to capture;to arrest	
取りあえず	at once;first of all;for the time being	
取り扱い	treatment;service;handling;management	
取り扱う	to treat;to handle;to deal in	
鳥居	torii (Shinto shrine archway)	
取り替え	swap;exchange	
取り組む	to tackle;to wrestle with;to engage in a bout;to come to grips with	
取り締まり	control;management;supervision	
取り締まる	to manage;to control;to supervise	
取り調べる	to investigate;to examine	
取り立てる	to collect;to extort;to appoint;to promote	
取り次ぐ	to act as an agent for;to announce (someone);to convey (a message)	
取り除く	to remove;to take away;to set apart	
取り引き	transactions;dealings;business	
取り巻く	to surround;to circle;to enclose	
取り混ぜる	to mix;to put together	
取り戻す	to take back;to regain	
取り寄せる	to order;to send away for	
取り分	especially;above all	
副	especially;above all	
蕩ける	to be enchanted with	
とんだ	terrible;awful;serious;preposterous;absolutely not	
胴	trunk;body;frame	
働	work;labor	
同	the same;the said;ibid.	
同意	agreement;consent;same meaning;same opinion;approval	
動員	mobilization	
同感	agreement;same opinion;same feeling;sympathy;concurrence	
動機	motive;incentive	
同級	the same grade;same class	
同居	living together	
動向	trend;tendency;movement;attitude	
同士	fellow;companion;comrade	
同志	same mind;comrade;kindred soul	
如何して	why?;for what reason;how;in what way;for what purpose;what for	
如何しても	by all means;at any cost;no matter what;after all;in the long run;cravingly;at any rate;surely	
同情	sympathy;compassion;sympathize;pity;feel for	
道場	dojo;hall used for martial arts training;mandala	
何卒	please;kindly;by all means	
どうぞ宜しく	pleased to meet you	
同調	sympathy;agree with;alignment;tuning	
動的	dynamic;kinetic	
同等	equality;equal;same rights;same rank	
堂々	magnificent;grand;impressive	
どうにか	in some way or other;one way or another	
導入	introduction;bringing in;leading in	
同封	enclosure (e.g. in a letter)	
同盟	alliance;union;league	
どうやら	it seems like;somehow or other	
動揺	disturbance;unrest;shaking;trembling;pitching;rolling;oscillation;agitation;excitement;commotion	
動力	power;motive power;dynamic force	
独裁	dictatorship;despotism	
読者	reader	
独自	original;peculiar;characteristic	
独占	monopoly	
独創	originality	
何処	where;what place	
何処か	somewhere;anywhere;in some respects	
土産	product of the land	
土台	foundation;base;basis	
何方	which;who	
土手	embankment;bank	
怒鳴る	to shout;to yell	
何の	which;what	
土俵	arena	
土木	public works	
何々	which (emphatic)	
度忘れ	lapse of memory;forget for a moment	
鈍感	thickheadedness;stolidity	
内閣	cabinet;(government) ministry	
乃至	from...to;between...and;or	
内臓	internal organs;intestines;viscera	
内部	interior;inside;internal	
内乱	civil war;insurrection;rebellion;domestic conflict	
内陸	inland	
苗	rice seedling	
尚	furthermore;still;yet;more;still more;greater;further;less	
尚更	all the more;still less	
中程	middle;midway	
流し	sink	
長々	long;drawn-out;very long	
殴る	to strike;to hit	
嘆く	to sigh;to lament;to grieve	
投げ出す	to throw down;to abandon;to sacrifice;to throw out	
和やか	mild;calm;gentle;quiet;harmonious	
名残	remains;traces;memory	
情け	sympathy;compassion	
情け深い	tender-hearted;compassionate	
為さる	to do	
詰る	to rebuke;to scold;to tell off	
何故	why;how	
何故なら	because	
名高い	famous;celebrated;well-known	
雪崩	avalanche	
懐く	to become emotionally attached	
名付ける	to name (someone)	
何気ない	casual;unconcerned	
何しろ	at any rate;anyhow;anyway;in any case	
何も	nothing	
何より	most;best	
七日	seven days;the seventh day (of the month)	
名札	name plate;name tag	
生臭い	smelling of fish or blood;fish or meat	
生温い	lukewarm;halfhearted	
生身	living flesh;flesh and blood;the quick	
鉛	lead (the metal)	
鈍る	to become less capable;to grow dull;to become blunt;to weaken	
並み	average;medium;common;ordinary	
滑らか	smoothness;glassiness	
嘗める	to lick;to taste;to experience;to make fun of;to make light of;to put down;to treat with contempt	
悩ましい	seductive;melancholy;languid	
悩ます	to afflict;to torment;to harass;to molest	
悩み	trouble(s);worry;distress;anguish;agony;problem	
平均	equilibrium;balance;average;mean	
慣らす	to accustom	
馴らす	to domesticate;to tame	
並びに	and	
成り立つ	to conclude;to consist of;to be practical (logical&nbsp;&nbsp;feasible&nbsp;&nbsp;viable);to hold true	
成る丈	as much as possible;if possible	
成るべく	as much as possible	
慣れ	practice;experience	
馴れ馴れしい	over-familiar	
難	difficulty;hardships;defect	
南	south	
なんか	things like ...;or something like that .. (often derogatory)	
何だか	a little;somewhat;somehow	
なんだかんだ	something or other	
何て	how...!;what...!	
何と	what;how;whatever	
何となく	somehow or other;for some reason or another	
何とも	nothing (with neg. verb);quite;not a bit	
何なり	any;anything;whatever	
荷	load;baggage;cargo	
似通う	to resemble closely	
面皰	pimple;acne	
賑わう	to prosper;to flourish;to do thriving business;to be crowded with people	
悪い	hateful;abominable;poor-looking	
憎しみ	hatred	
肉親	blood relationship;blood relative	
肉体	the body;the flesh	
逃げ出す	to run away;to escape from	
西日	westering sun	
滲む	to run;to blur;to spread;to blot;to ooze	
日夜	day and night;always	
日当	daily allowance	
荷造り	packing;baling;crating	
担う	to carry on shoulder;to bear (burden);to shoulder (gun)	
二人	two persons;two people;pair;couple	
にも拘らず	in spite of;nevertheless	
入手	obtaining;coming to hand	
入賞	winning a prize or place (in a contest)	
入浴	bathe;bathing	
尿	urine	
俄か	sudden;abrupt;unexpected;improvised;offhand	
認識	recognition;cognizance	
妊娠	conception;pregnancy	
人情	humanity;empathy;kindness;sympathy;human nature;common sense;customs and manners	
任務	duty;function;office;mission;task	
任命	appointment;nomination;ordination;commission;designation	
抜かす	to omit;to leave out	
抜け出す	to slip out;to sneak away;to excel	
盗み	stealing	
沼	swamp;bog;pond;lake	
音	sound;note	
値打ち	value;worth;price;dignity	
寝かせる	to put to bed;to lay down;to ferment	
捻子	screw;helix;spiral	
ねじ回し	screwdriver	
捻じれる	to twist;to wrench;to screw	
鼠	1.&nbsp;&nbsp;mouse;rat; 2.&nbsp;&nbsp;dark gray;slate color	
妬む	to be jealous;to be envious	
強請る	to tease;to coax;to solicit;to demand	
熱湯	boiling water	
熱意	zeal;enthusiasm	
熱量	temperature	
粘り	stickyness;viscosity	
粘る	to be sticky;to be adhesive;to persevere;to persist;to stick to	
値引き	price reduction;discount	
根回し	making necessary arrangements	
眠たい	sleepy	
練る	to knead;to work over;to polish up	
念	sense;idea;thought;feeling;desire;concern;attention;care	
年鑑	yearbook	
年号	name of an era;year number	
燃焼	burning;combustion	
年生	pupil in .... year;student in .... year	
年長	seniority	
燃料	fuel	
年輪	annual tree ring	
脳	brain;memory	
農耕	farming;agriculture	
農場	farm (agriculture)	
農地	agricultural land	
納入	payment;supply	
逃す	to let loose;to set free;to let escape	
逃れる	to escape	
軒並み	row of houses	
鋸	saw	
望ましい	desirable;hoped for	
臨む	to look out on;to face;to deal with;to attend (function)	
乗っ取る	to capture;to occupy;to usurp	
長閑	tranquil;calm;quiet	
罵る	to speak ill of;to abuse	
延べ	futures;credit (buying);stretching;total	
飲み込む	to gulp down;to swallow deeply;to understand;to take in;to catch on to;to learn;to digest	
乗り換え	transfer (trains&nbsp;&nbsp;buses&nbsp;&nbsp;etc.)	
乗り込む	to board;to embark on;to get into (a car);to ship (passengers);to man (a ship);to help (someone) int	
刃	edge (of a sword)	
派	clique;faction;school	
把握	grasp;catch;understanding	
肺	lung	
廃棄	annullment;disposal;abandon;scrap;discarding;repeal	
配給	distribution (eg. films&nbsp;&nbsp;rice)	
配偶者	spouse;wife;husband	
拝啓	Dear (so and so)	
背景	background;scenery;setting;circumstance	
背後	back;rear	
灰皿	ashtray	
廃止	abolition;repeal	
拝借	borrowing	
排除	exclusion;removal;rejection	
排水	drainage	
敗戦	defeat;losing a war	
配置	arrangement (of resources);disposition	
配布	distribution	
配分	distribution;allotment	
配慮	consideration;concern;forethought	
配列	arrangement;array (programming)	
映える	to shine;to look attractive;to look pretty	
破壊	destruction	
墓地	cemetery;graveyard	
捗る	to make progress;to move right ahead (with the work);to advance	
果ない	fleeting;transient;short-lived;momentary;vain;fickle;miserable;empty;ephemeral	
諮る	to consult with;to confer	
図る	to plot;to attempt;to plan;to take in;to deceive;to devise;to design;to refer A to B	
剥がす	to tear off;to peel off;to rip off;to strip off;to skin;to flay;to disrobe;to deprive of;to detach;t	
破棄	revocation;annulment;breaking (e.g. treaty)	
泊	counter for nights of a stay	
迫害	persecution	
薄弱	feebleness;weakness;weak	
白状	confession	
剥ぐ	to tear off;to peel off;to rip off;to strip off;to skin;to flay;to disrobe;to deprive of	
派遣	dispatch;send	
励ます	to encourage;to cheer;to raise (the voice)	
励む	to be zealous;to brace oneself;to endeavour;to strive;to make an effort	
剥げる	to come off;to be worn off;to fade;to discolor	
鋏	scissors	
柱	pillar;post	
橋渡し	bridge building;mediation	
恥	shame;embarrassment	
弾く	to flip;to snap	
始め	beginning;start;origin	
始めまして	How do you do?;I am glad to meet you	
恥じらう	to feel shy;to be bashful;to blush	
恥じる	to feel ashamed	
蓮	lotus	
筈	it should be so	
弾む	to spring;to bound;to bounce;to be stimulated;to be encouraged;to get lively;to treat oneself to;to	
破損	damage	
機	loom	
果たして	as was expected;really	
果たす	to accomplish;to fulfill;to carry out;to achieve	
裸足	barefoot	
蜂蜜	honey	
発掘	excavation;exhumation	
発生	outbreak;spring forth;occurrence;incidence;origin	
発足	starting;inauguration	
初	first;new	
発	departure;beginning;counter for gunshots	
発育	(physical) growth;development	
発芽	burgeoning	
発言	utterance;speech;proposal	
発病	attack (disease)	
初耳	something heard for the first time	
果て	the end;the extremity;the limit(s);the result	
果てる	to end;to be finished;to be exhausted;to die;to perish	
話し合い	discussion;conference	
甚だ	very;greatly;exceedingly	
華々しい	brilliant;magnificent;spectacular	
花びら	(flower) petal	
華やか	gay;showy;brilliant;gorgeous;florid	
阻む	to keep someone from doing;to stop;to prevent;to check;to hinder;to obstruct;to oppose;to thwart	
浜	beach;seashore	
浜辺	beach;foreshore	
填まる	to get into;to go into;to fit;to be fit for;to suit;to fall into;to plunge into;to be deceived;to be	
歯磨	dentifrice;toothpaste	
填める	to get in;to insert;to put on;to make love	
生やす	to grow;to cultivate;to wear beard	
早める	to hasten;to quicken;to expedite;to precipitate;to accelerate	
流行	fashionable;fad;in vogue;prevailing	
腹立ち	anger	
原っぱ	open field;empty lot;plain	
張り紙	paper patch;paper backing;poster	
遥か	far;far-away;distant;remote;far off	
破裂	explosion;rupture;break off	
腫れる	to swell (from inflammation);to become swollen	
班	group;party;section (mil)	
判	seal;stamp;monogram signature;judgment	
版	edition	
繁栄	prospering;prosperity;thriving;flourishing	
反感	antipathy;revolt;animosity	
版画	art print	
反響	echo;reverberation;repercussion;reaction;influence	
判決	judicial decision;judgement;sentence;decree	
反撃	counterattack;counteroffensive;counterblow	
反射	reflection;reverberation	
繁殖	breed;multiply;increase;propagation	
繁盛	prosperity;flourishing;thriving	
反する	to be inconsistent with;to oppose;to contradict;to transgress;to rebel	
判定	judgement;decision;award;verdict	
反応	reaction;response	
半端	remnant;fragment;incomplete set;fraction;odd sum;incompleteness	
反発	repelling;rebound;recover;oppose	
反乱	insurrection;mutiny;rebellion;revolt;uprising	
氾濫	overflowing;flood	
黴菌	bacteria;germ(s)	
賠償	reparations;indemnity;compensation	
倍率	diameter;magnification	
馬鹿馬鹿しい	stupid	
馬鹿らしい	absurd	
漠然	obscure;vague;equivocal	
爆弾	bomb	
爆破	blast;explosion;blow up	
暴露	disclosure;exposure;revelation	
化ける	to appear in disguise;to take the form of;to change for the worse	
罰	(divine) punishment;curse;retribution	
伐	strike;attack;punish	
ばてる	to be exhausted;to be worn out	
発条	spring (e.g. coil&nbsp;&nbsp;leaf)	
散蒔く	to disseminate;to scatter;to give money freely	
万	many;all	
万人	all people;everybody;10000 people	
万能	all-purpose;almighty;omnipotent	
番目	cardinal number suffix	
非	faulty-;non-	
費	cost;expense	
延いては	not only...but also;in addition to;consequently	
控室	waiting room	
控える	to draw in;to hold back;to make notes;to be temperate in	
悲観	pessimism;disappointment	
匹	head;small animal counter;roll of cloth	
引き上げる	to withdraw;to leave;to pull out;to retire	
率いる	to lead;to spearhead (a group);to command (troops)	
引き受ける	to undertake;to take up;to take over;to be responsible for;to guarantee;to contract (disease)	
引き起こす	to cause	
引き下げる	to pull down;to lower;to reduce;to withdraw	
引きずる	to seduce;to drag along;to pull;to prolong;to support	
引き取る	to take charge of;to take over;to retire to a private place	
引き分け	a draw (in competition);tie game	
否決	rejection;negation;voting down	
非行	delinquency;misconduct	
日頃	normally;habitually	
久しい	long;long-continued;old (story)	
久し振り	after a long time	
悲惨	misery	
秘書	(private) secretary	
比重	specific gravity	
密か	secret;private;surreptitious	
浸す	to soak;to dip;to drench	
一向	earnestly	
左利き	left-handedness;sake drinker;left-hander	
引っ掻く	to scratch	
引っ掛ける	1.&nbsp;&nbsp;to hang (something) on (something);to throw on (clothes); 2.&nbsp;&nbsp;to hook;to catch;to trap;to ensnar	
必修	required (subject)	
匹敵	comparing with;match;rival;equal	
未	eighth sign of Chinese zodiac (The Ram&nbsp;&nbsp;1pm-3pm&nbsp;&nbsp;south-southwest&nbsp;&nbsp;June)	
必然	inevitable;necessary	
一息	puffy;a breath;a pause;an effort	
単	one layer;single	
人柄	personality;character;personal appearance;gentility	
一頃	once;some time ago	
人質	hostage;prisoner	
一筋	a line;earnestly;blindly;straightforwardly	
一まず	for the present;once;in outline	
一人でに	by itself;automatically;naturally	
酷い	cruel;awful;severe;very bad;serious;terrible;heavy;violent	
日取り	fixed date;appointed day	
雛	young bird;chick;doll	
日向	sunny place;in the sun	
非難	blame;attack;criticism	
避難	taking refuge;finding shelter	
日の丸	the Japanese flag	
火花	spark	
日々	every day;daily;day after day	
悲鳴	shriek;scream	
百科事典	encyclopedia	
百科辞典	encyclopedia	
冷やかす	to banter;to make fun of;to jeer at;to cool;to refrigerate	
日焼け	sunburn	
票	label;ballot;ticket;sign	
標語	motto;slogan;catchword	
ひょっと	possibly;accidentally	
平たい	flat;even;level;simple;plain	
比率	ratio;proportion;percentage	
肥料	manure;fertilizer	
比例	proportion	
疲労	fatigue;weariness	
広まる	to spread;to be propagated	
貧困	poverty;lack	
品質	quality	
品種	brand;kind;description	
貧弱	poor;meagre;insubstantial	
頻繁	frequency	
美	beauty	
微笑	smile	
美術	art;fine arts	
吃驚	be surprised;be amazed;be frightened;astonishment	
びっしょり	wet through;drenched	
描写	depiction;description;portrayal	
びり	last on the list;at the bottom	
微量	minuscule amount;extremely small quantity	
敏感	sensibility;susceptibility;sensitive (to);well attuned to	
貧乏	poverty;destitute;poor	
歩	pawn (in chess or shogi)	
不意	sudden;abrupt;unexpected;unforeseen	
封	seal	
封鎖	blockade;freezing (funds)	
風習	custom	
風俗	1.&nbsp;&nbsp;manners;customs; 2.&nbsp;&nbsp;sex service;sex industry	
風土	natural features;topography;climate;spiritual features	
不可欠	indispensable;essential	
深める	to deepen;to heighten;to intensify	
不吉	ominous;sinister;bad luck;ill omen;inauspiciousness	
不況	recession;depression;slump	
布巾	tea-towel;dish cloth	
福	good fortune	
復旧	restoration;restitution;rehabilitation	
複合	composite;complex	
福祉	welfare;well-being	
覆面	mask;veil;disguise	
膨れる	to get cross;to get sulky;to swell (out);to expand;to be inflated;to distend;to bulge	
不景気	business recession;hard times;depression;gloom;sullenness;cheerlessness	
老ける	to age	
布告	edict;ordinance;proclamation	
富豪	wealthy person;millionaire	
負債	debt;liabilities	
相応しい	appropriate	
不在	absence	
不山戯る	to romp;to gambol;to frolic;to joke;to make fun of;to flirt	
負傷	injury;wound	
不審	incomplete understanding;doubt;question;distrust;suspicion;strangeness;infidelity	
不振	dullness;depression;slump;stagnation	
不順	irregularity;unseasonableness	
付属	attached;belonging;affiliated;annexed;associated;subordinate;incidental;dependent;auxiliary	
負担	burden;charge;responsibility	
不調	bad condition;not to work out (ie a deal);disagreement;break-off;disorder;slump;out of form	
復活	revival (e.g. musical);restoration	
復興	revival;renaissance;reconstruction	
沸騰	boiling;seething	
仏	French	
不図	suddenly;casually;accidentally;incidentally;unexpectedly;unintentionally	
不当	injustice;impropriety;unreasonableness;undeservedness;unfair;invalid	
不動産	real estate	
赴任	(proceeding to) new appointment	
腐敗	decay;depravity	
不評	bad reputation;disgrace;unpopularity	
不便	pity;compassion	
不服	dissatisfaction;discontent;disapproval;objection;complaint;protest;disagreement	
普遍	universality;ubiquity;omnipresence	
踏まえる	to be based on;to have origin in	
文	letter;writings	
不明	unknown;obscure;indistinct;uncertain;ambiguous;ignorant;lack of wisdom;anonymous;unidentified	
扶養	support;maintenance	
振り	pretence;show;appearance	
振り出し	outset;starting point;drawing or issuing (draft)	
不良	badness;delinquent;inferiority;failure	
浮力	buoyancy;floating power	
震わせる	to be shaking;to be trembling	
付録	appendix;supplement	
分	minute	
憤慨	indignation;resentment	
紛失	losing something	
噴出	spewing;gushing;spouting;eruption;effusion	
紛争	dispute;trouble;strife	
ふんだん	plentiful;abundant;lavish	
奮闘	hard struggle;strenuous effort	
粉末	fine powder	
部	department;part;category;counter for copies of a newspaper or magazine	
部下	subordinate person	
ぶかぶか	too big;baggy	
侮辱	insult;contempt;slight	
武装	arms;armament;armed	
斑	spots;speckles;mottles	
物資	goods;materials	
物体	body;object	
物議	public discussion (criticism)	
打付ける	to knock;to run into;to nail on;to strike hard;to hit and attack	
仏像	Buddhist image (statue)	
無難	safety;security	
部門	class;group;category;department;field;branch	
ぶら下げる	to hang;to suspend;to dangle;to swing	
ぶらぶら	dangle heavily;swing;sway to and fro;aimlessly;idly;lazily;loiter;loaf;be idle;stroll idly	
武力	armed might;military power;the sword;force	
無礼	impolite;rude	
文化財	cultural assets;cultural property	
分業	division of labor;specialization;assembly-line production	
文語	written language;literary language	
分散	dispersion;decentralization;variance (statistics)	
分子	numerator;molecule	
文書	document;writing;letter;note;records;archives	
分担	apportionment;sharing	
分配	division;sharing	
分母	denominator	
分離	separation;detachment;segregation;isolation	
分裂	split;division;break up	
兵器	arms;weapons;ordinance	
閉口	shut mouth	
平行	(going) side by side;concurrent;abreast;at the same time;occurring together;parallel;parallelism	
閉鎖	closing;closure;shutdown;lockout;unsociable	
兵士	soldier	
平常	normal;usual	
平方	square (e.g. metre);square	
並列	arrangement;parallel;abreast	
辟易	wince;shrink back;succumbing to;being frightened;disconcerted	
臍	navel;belly-button	
隔たる	to be distant	
謙る	to deprecate oneself and praise the listener	
経る	to pass;to elapse;to experience	
編	compilation;editing;completed poem;book;part of book	
偏	side;left radical of a character;inclining;inclining toward;biased	
変革	change;reform;revolution;upheaval;(the) Reformation	
返還	return;restoration	
偏見	prejudice;narrow view	
返済	repayment	
変遷	change;transition;vicissitudes	
返答	reply	
変動	change;fluctuation	
弁解	explanation;justification;defence;excuse	
便宜	convenience;accommodation;advantage;expedience	
弁護	defense;pleading;advocacy	
弁償	next word;compensation;reparation;indemnity;reimbursement	
弁論	discussion;debate;argument	
ぺこぺこ	fawn;be very hungry	
穂	ear (of plant);head (of plant)	
保育	nursing;nurturing;rearing;lactation;suckling	
倣	imitate;follow;emulate	
法案	bill (law)	
崩壊	collapse;decay (physics);crumbling;breaking down;caving in	
法学	law;jurisprudence	
放棄	abandonment;renunciation;abdication (responsibility&nbsp;&nbsp;right)	
宝器	treasured article or vessel;outstanding individual	
封建	feudalistic	
豊作	abundant harvest;bumper crop	
方策	plan;policy	
奉仕	attendance;service	
方式	form;method;system	
放射	radiation;emission	
放射能	radioactivity	
報酬	remuneration;recompense;reward;toll	
放出	release;emit	
報じる	to inform;to report	
報ずる	to inform;to report	
放置	leave as is;leave to chance;leave alone;neglect	
法廷	courtroom	
報道	information;report	
褒美	reward;prize	
葬る	to bury;to inter;to entomb;to consign to oblivion;to shelve	
放り込む	to throw into	
放り出す	to throw out;to fire;to expel;to give up;to abandon;to neglect	
飽和	saturation	
保温	retaining warmth;keeping heat in;heat insulation	
捕獲	capture;seizure	
保管	charge;custody;safekeeping;deposit;storage	
補給	supply;supplying;replenishment	
補強	compensation;reinforcement	
保険	insurance;guarantee	
捕鯨	whaling;whale fishing	
誇る	to boast of;to be proud of	
綻びる	to come apart at the seams;to begin to open;to smile broadly	
保護	care;protection;shelter;guardianship;favor;patronage	
干し物	dried washing (clothes)	
保守	conservative;maintaining	
保障	guarantee;security;assurance;pledge;warranty	
補償	compensation;reparation	
補充	supplementation;supplement;replenishment;replenishing	
補助	assistance;support;aid;auxiliary	
舗装	pavement;road surface	
補足	supplement;complement	
発作	fit;spasm	
ほっと	feel relieved	
頬っぺた	cheek	
辺り	(in the) neighbourhood;vicinity;nearby	
殆ど	mostly;almost	
解く	to unfasten	
施す	to donate;to give;to conduct;to apply;to perform	
保母	day care worker in a kindergarten&nbsp;&nbsp;nursery school&nbsp;&nbsp;etc.	
保養	health preservation;recuperation;recreation	
捕吏	constable	
捕虜	prisoner (of war)	
滅びる	to be ruined;to go under;to perish;to be destroyed	
滅ぼす	to destroy;to overthrow;to wreck;to ruin	
本格	propriety;fundamental rules	
本館	main building	
本気	seriousness;truth;sanctity	
本質	essence;true nature;reality	
本体	substance;real form;object of worship	
本音	real intention;motive	
本の	mere;only;just	
本能	instinct	
本場	home;habitat;center;best place;genuine	
本文	text (of document);body (of letter)	
本名	real name	
卯	fourth sign of Chinese zodiac (The Hare&nbsp;&nbsp;5am-7am&nbsp;&nbsp;east&nbsp;&nbsp;February)	
防衛	defense;protection;self-defense	
防火	fire prevention;fire fighting;fire proof	
妨害	disturbance;obstruction;hindrance;jamming;interference	
紡績	spinning	
呆然	dumbfounded;overcome with surprise;in blank amazement	
膨脹	expansion;swelling;increase;growth	
冒頭	beginning;start;outset	
暴動	insurrection;rebellion;revolt;riot;uprising	
暴風	storm;windstorm;gale	
暴力	violence	
募金	fund-raising;collection of funds	
牧師	pastor;minister;clergyman	
母校	alma mater	
没収	forfeited	
坊ちゃん	son (of others)	
ぼつぼつ	gradually;here and there;spots;pimples	
没落	ruin;fall;collapse	
ぼやく	to grumble;to complain	
ぼやける	to become dim;to become blurred	
藍褸	rag;scrap;tattered clothes;fault (esp. in a pretense);defect;run-down or junky	
枚	counter for flat objects (e.g. sheets of paper)	
埋蔵	buried property;treasure trove	
舞う	to dance;to flutter about;to revolve	
真上	just above;right overhead	
前売り	advance sale;booking	
前置き	preface;introduction	
前もって	in advance;beforehand;previously	
任す	to entrust;to leave to a person	
負かす	to defeat	
賄う	to give board to;to provide meals;to pay	
曲がる	to turn;to bend	
巻	volume	
紛らわしい	confusing;misleading;equivocal;ambiguous	
紛れる	to be diverted;to slip into	
膜	membrane;film	
捲る	verb suffix to indicate reckless abandon to the activity	
真心	sincerity;devotion	
誠	truth;faith;fidelity;sincerity;trust;confidence;reliance;devotion	
真に	truly;actually;really	
まごつく	to be confused;to be flustered	
正しく	surely;no doubt;evidently	
正に	correctly;surely	
勝る	to excel;to surpass;to outrival	
増し	extra;additional;less objectionable;better;preferable	
真下	right under;directly below	
況して	still more;still less (with neg. verb);to say nothing of;not to mention	
交える	to mix;to converse with;to cross (swords)	
交わる	to cross;to intersect;to associate with;to mingle with;to interest;to join	
麻酔	anaesthesia	
益々	increasingly;more and more	
不味い	unappetising;unpleasant (taste&nbsp;&nbsp;appearance&nbsp;&nbsp;situation);ugly;unskilful;awkward;bungling;unwise;untime	
股	groin;crotch;thigh	
跨がる	to extend over or into;to straddle	
跨ぐ	to straddle	
瞬き	wink;twinkling (of stars);flicker (of light)	
待ち合わせ	appointment	
間違う	to make a mistake;to be incorrect;to be mistaken	
待ち遠しい	looking forward to	
待ち望む	to look anxiously for;to wait eagerly for	
区々	1.&nbsp;&nbsp;several;various;divergent;conflicting;different;diverse; 2.&nbsp;&nbsp;trivial	
末期	closing years (period&nbsp;&nbsp;days);last stage	
真っ二つ	in two equal parts	
纏まり	conclusion;settlement;consistency	
纏め	settlement;conclusion	
免れる	to escape from;to be rescued from;to avoid;to evade;to avert;to elude;to be exempted;to be relieved	
招き	invitation	
麻痺	paralysis;palsy;numbness;stupor	
眩しい	dazzling;radiant	
目蓋	eyelid	
間々	occasionally;frequently	
間もなく	soon;before long;in a short time	
眉	eyebrow	
鞠	ball	
丸ごと	in its entirety;whole;wholly	
丸っきり	completely;perfectly;just as if	
丸で	quite;entirely;completely;at all;as if;as though;so to speak	
丸々	completely	
丸める	to make round;to round off;to roll up;to curl up;to seduce;to cajole;to explain away	
満月	full moon	
満場	unanimous;whole audience	
真ん中	middle;centre;mid-way	
真ん前	right in front;under the nose	
真ん丸い	perfectly circular	
三	(num) three	
見合い	formal marriage interview	
見合わせる	to exchange glances;to postpone;to suspend operations;to refrain from performing an action	
見落とす	to overlook;to fail to notice	
未開	savage land;backward region;uncivilized	
味覚	taste;palate;sense of taste	
見掛ける	to (happen to) see;to notice;to catch sight of	
三日月	new moon;crescent moon	
見方	viewpoint	
見苦しい	unsightly;ugly	
見込み	hope;prospects;expectation	
未婚	unmarried	
惨め	miserable	
未熟	inexperience;unripeness;raw;unskilled;immature;inexperienced	
微塵	particle;atom	
見すぼらしい	shabby;seedy	
見せびらかす	to show off;to flaunt	
見せ物	show;exhibition	
満たす	to satisfy;to ingratiate;to fill;to fulfill	
乱す	to throw out of order;to disarrange;to disturb	
乱れる	to get confused;to be disordered;to be disturbed	
未知	not yet known	
導く	to be guided;to be shown	
身近	near oneself;close to one;familiar	
密集	crowd;close formation;dense	
密接	related;connected;close;intimate	
見っともない	shameful;indecent	
蜜	nectar;honey	
密度	density	
見積り	estimation;quotation	
未定	not yet fixed;undecided;pending	
見通し	perspective;unobstructed view;outlook;forecast;prospect;insight	
源	source;origin	
身なり	personal appearance	
峰	peak;ridge	
見逃す	to miss;to overlook;to leave at large	
見晴らし	view	
身振り	gesture	
見舞	enquiry;expression of sympathy;expression of concern	
脈	pulse	
未練	lingering affection;attachment;regret(s);reluctance	
見渡す	to look out over;to survey (scene);to take an extensive view of	
民主	democratic;the head of the nation	
民宿	private home providing lodging for travelers	
民族	people;race;nation;racial customs;folk customs	
民俗	people;race;nation;racial customs;folk customs	
六	(num) six	
無意味	nonsense;no meaning	
向き	direction;situation;exposure;aspect;suitability	
無口	reticence	
向け	for ~;oriented towards ~	
婿	son-in-law	
無効	invalid;no effect;unavailable	
無言	silence	
毟る	to pluck;to pick;to tear	
無邪気	innocence;simple-mindedness	
結び	ending;conclusion;union	
結び付き	connection;relation	
結び付く	to be connected or related;to join together	
結び付ける	to combine;to join;to tie on;to attach with a knot	
無線	wireless;radio	
無駄遣い	waste money on;squander money on;flog a dead horse	
無断	without permission;without notice	
無知	ignorance	
無茶	absurd;unreasonable;excessive;rash;absurdity;nonsense	
無茶苦茶	confused;jumbled;mixed up;unreasonable	
空しい	vacant;futile;vain;void;empty;ineffective;lifeless	
無念	chagrin;regret	
無能	inefficiency;incompetence	
無闇に	unreasonably;absurdly;recklessly;indiscreetly;at random	
無用	useless;futility;needlessness;unnecessariness	
群がる	to swarm;to gather	
無論	of course;naturally	
名産	noted product	
名称	name	
命中	a hit	
名簿	register of names	
名誉	honor;credit;prestige	
明瞭	clarity	
明朗	bright;clear;cheerful	
目方	weight	
恵み	blessing	
恵む	to bless;to show mercy to	
目覚しい	brilliant;splendid;striking;remarkable	
目覚める	to wake up	
召す	to call;to send for;to put on;to wear;to take (a bath);to ride in;to buy;to eat;to drink;to catch (a	
雌	female (animal)	
滅茶苦茶	absurd;unreasonable;excessive;messed up;spoiled;wreaked	
目付き	look;expression of the eyes;eyes	
滅亡	downfall;ruin;collapse;destruction	
愛でたい	auspicious	
目眩	dizziness;giddiness	
目盛	scale;gradations	
面会	interview	
免除	exemption;exoneration;discharge	
面する	to face on;to look out on to	
面目	face;honour;reputation;prestige;dignity;credit	
設ける	to create;to establish	
申し入れる	to propose;to suggest	
申し込み	application;entry;request;subscription;offer;proposal;overture;challenge	
申出	proposal;request;claim;report;notice	
申し出る	to report to;to tell;to suggest;to submit;to request;to make an offer;to come forward with informati	
申し分	objection;shortcomings	
盲点	blind spot	
猛烈	violent;vehement;rage	
藻掻く	to struggle;to wriggle;to be impatient	
目録	catalogue;catalog;list	
目論見	a plan;a scheme;a project;a program;intention;goal	
模型	model;dummy;maquette	
模索	groping (for)	
若し	if;in case;supposing	
若しかしたら	perhaps;maybe;by some chance	
若しかして	perhaps;possibly	
若しかすると	perhaps;maybe;by some chance	
若しくは	or;otherwise	
若しも	if	
齎らす	to bring;to take;to bring about	
凭れる	to lean against;to lean on;to recline on;to lie heavy (on the stomach)	
持ち	1.&nbsp;&nbsp;hold;charge;keep possession;in charge; 2.&nbsp;&nbsp;wear;durability;life;draw; 3.&nbsp;&nbsp;usage (suff)	
持ち切り	hot topic;talk of the town	
物体ない	too good;more than one deserves;wasteful;sacrilegious;unworthy of	
以て	with;by;by means of;because;in view of	
専ら	wholly;solely;entirely	
持て成す	to entertain;to make welcome	
持てる	to be well liked;to be popular	
基	basis	
物置き	storeroom	
物好き	curiosity	
物足りない	unsatisfied;unsatisfactory	
最早	already;now	
模範	exemplar;exemplification;exemplum;model;example	
模倣	imitation;copying	
揉める	to disagree;to dispute	
腿	thigh;femur	
催す	to hold (a meeting);to give (a dinner);to feel;to show signs of;to develop symptoms of;to feel (sick	
漏らす	to let leak;to reveal	
盛り上がる	to rouse;to swell;to rise	
漏る	to leak;to run out	
漏れる	to leak out;to escape;to come through;to shine through;to filter out;to be omitted	
脆い	brittle;fragile;tender-hearted	
もろに	completely;all the way	
問	problem;question	
矢	arrow	
哉	question mark	
喧しい	noisy;strict;fussy	
野外	fields;outskirts;open air;suburbs	
軈て	before long;soon;at length	
夜行	walking around at night;night train;night travel	
役職	post;managerial position;official position	
役立つ	to be useful;to be helpful;to serve the purpose	
役場	town hall	
夜具	bedding	
優	gentle;affectionate	
屋敷	mansion	
養う	to rear;to maintain;to cultivate	
社	Shinto shrine	
野心	ambition;aspiration;designs;treachery	
易い	easy	
安っぽい	cheap-looking;tawdry;insignificant	
休める	to rest;to suspend;to give relief	
野生	wild	
矢鱈に	randomly;recklessly;blindly	
夜中	all night;the whole night	
奴	servant;fellow	
やっ付ける	to beat	
矢っ張り	also;as I thought;still;in spite of;absolutely	
野党	opposition party	
病	illness;disease	
闇	darkness;the dark;black-marketeering;dark;shady;illegal	
病む	to fall ill;to be ill	
止むを得ない	cannot be helped;unavoidable	
稍	a little;partially;somewhat;a short time;a while	
ややこしい	puzzling;tangled;complicated;complex	
遣り通す	to carry through;to achieve;to complete	
やり遂げる	to accomplish	
遣る	to do;to have sexual intercourse;to kill;to give (to inferiors&nbsp;&nbsp;animals&nbsp;&nbsp;etc.);to dispatch (a letter	
和らげる	to soften;to moderate;to relieve	
優位	predominance;ascendancy;superiority	
憂鬱	depression;melancholy;dejection;gloom	
有益	beneficial;profitable	
優越	supremacy;predominance;being superior to	
勇敢	bravery;heroism;gallantry	
有機	organic	
夕暮れ	evening;(evening) twilight	
融資	financing;loan	
有する	to own;to be endowed with	
融通	lending (money);accommodation;adaptability;versatility;finance	
優勢	superiority;superior power;predominance;preponderance	
優先	preference;priority	
誘導	guidance;leading;induction;introduction;incitement;inducement	
優美	grace;refinement;elegance	
有望	good prospects;full of hope;promising	
遊牧	nomadism	
夕焼け	sunset	
有力	1.&nbsp;&nbsp;influence;prominence; 2.&nbsp;&nbsp;potent	
幽霊	ghost;specter;apparition;phantom	
誘惑	temptation;allurement;lure	
揺さぶる	to shake;to jolt;to rock;to swing	
茹でる	to boil	
ゆとり	reserve;affluence;room;time (to spare)	
指差す	to point at	
弓	bow (and arrow)	
揺らぐ	to swing;to sway;to shake;to tremble	
緩む	to become loose;to slacken	
緩める	to loosen;to slow down	
緩やか	lenient	
世	world;society;age;generation	
好い	good	
要因	primary factor;main cause	
溶液	solution (liquid)	
用件	business	
養護	protection;nursing;protective care	
用紙	blank form	
様式	style;form;pattern	
要する	to demand;to require;to take	
要請	claim;demand;request;application	
養成	training;development	
様相	aspect	
用品	articles;supplies;parts	
洋風	western style	
用法	directions;rules of use	
要望	demand for;request	
余暇	leisure;leisure time;spare time	
予感	presentiment;premonition	
余興	side show;entertainment	
預金	deposit;bank account	
抑圧	check;restraint;oppression;suppression	
浴室	bathroom;bath	
抑制	suppression	
欲深い	greedy	
欲望	desire;appetite	
寄こす	to send;to forward	
横綱	sumo grand champion	
葦	reed;bulrush	
善し悪し	good or bad;merits or demerits;quality;suitability	
予想	expectation;anticipation;prediction;forecast	
余所見	looking away;looking aside	
余地	place;room;margin;scope	
依って	therefore;consequently;accordingly;because of	
余程	very;greatly;much;to a large extent;quite	
与党	government party;(ruling) party in power;government	
呼び止める	to challenge;to call somebody to halt	
夜更かし	staying up late;keeping late hours;sitting up late at night;nighthawk	
夜更け	late at night	
読み上げる	to read out loud (and clearly);to call a roll	
寄り掛かる	to lean against;to recline on;to lean on;to rely on	
宜しく	well;properly;suitably;best regards;please remember me	
弱まる	to abate;to weaken;to be emaciated;to be dejected;to be perplexed	
弱める	to weaken	
弱る	to weaken;to be troubled;to be downcast;to be emaciated;to be dejected;to be perplexed;to impair	
来場	attendance	
酪農	dairy (farm)	
落下	fall;drop;come down	
楽観	optimism	
濫用	abuse;misuse;misappropriation;using to excess	
理屈	theory;reason	
利根	intelligence	
利子	interest (bank)	
利潤	profit;returns	
理性	reason;sense	
利息	interest (bank)	
立体	solid body	
立法	legislation;lawmaking	
利点	advantage;point in favor	
略語	abbreviation;acronym	
略奪	pillage;plunder;looting;robbery	
流	styleof;method of;manner of	
流通	circulation of money or goods;flow of water or air;distribution	
了	finish;completion;understanding	
料	material;charge;rate;fee	
領域	area;domain;territory;field;region;regime	
了解	comprehension;consent;understanding;roger (on the radio)	
領海	territorial waters	
両極	both extremities;north and south poles;positive and negative poles	
良好	favorable;satisfactory	
良識	good sense	
良質	good quality;superior quality	
了承	acknowledgement;understanding (e.g. please be understanding of the mess during our renovation)	
良心	conscience	
領地	territory;dominion	
領土	dominion;territory;possession	
両立	compatibility;coexistence;standing together	
旅客	passenger (transport)	
旅券	passport	
履歴	personal history;background;career;log	
理論	theory	
輪	counter for wheels and flowers	
林業	forestry	
類似	analogous	
類推	analogy	
冷酷	cruelty;coldheartedness;relentless;ruthless	
冷蔵	cold storage;refrigeration	
冷淡	coolness;indifference	
恋愛	love;love-making;passion;emotion;affections	
連休	consecutive holidays	
連日	every day;prolonged	
連中	colleagues;company;a lot	
連帯	solidarity	
連邦	commonwealth;federation of states	
連盟	league;union;alliance	
老衰	senility;senile decay	
朗読	reading aloud;recitation	
浪費	waste;extravagance	
労力	labour;effort;toil;trouble	
碌な	satisfactory;decent	
碌に	well;enough;sufficient	
露骨	1.&nbsp;&nbsp;frank;blunt;plain;outspoken; 2.&nbsp;&nbsp;conspicuous;open; 3.&nbsp;&nbsp;broad;suggestive	
論議	discussion	
論理	logic	
和	sum;harmony;peace	
我がまま	selfishness;egoism;wilfulness;disobedience;whim	
枠	frame;slide	
惑星	planet	
技	art;technique	
態と	on purpose	
態々	expressly;specially;doing something especially rather than incidentally	
煩わしい	troublesome;annoying;complicated	
渡り鳥	migratory bird;bird of passage	
詫び	apology	
和風	Japanese style	
和文	Japanese text;sentence in Japanese	
藁	straw	
割合に	comparatively	
割り当て	allotment;assignment;allocation;quota;rationing	
割り込む	to cut in;to thrust oneself into;to wedge oneself in;to muscle in on;to interrupt;to disturb	
割り算	division (math)	
割引き	discount;reduction;rebate;tenths discounted	
悪者	bad fellow;rascal;ruffian;scoundrel	
アイデア	idea	
アクセル	accelerator	
アップ	up	
アプローチ	approach (in golf)	
アマチュア	amateur	
アラブ	Arab	
アルカリ	alkali	
アルミ	aluminum (Al);aluminium	
アワー	hour	
アンケート	(fr:) (n) questionnaire (fr: enquete);survey	
アンコール	encore	
イエス	Jesus;yes	
インターチェンジ	interchange	
インターナショナル	international	
インターフォン	intercom	
インテリ	egghead;intelligentsia	
インフォメーション	information	
インフレ	inflation	
ウェートレス	waitress	
エアメール	air mail	
エレガント	elegant	
エンジニア	engineer	
オーケー	OK	
オートマチック	automatic	
オープン	open	
オリエンテーション	orientation	
オレンジ	an orange	
オンライン	on-line	
カーペット	carpet	
カクテル	cocktail	
カット	cut;cutting	
カテゴリー	category	
カムバック	comeback	
カメラマン	cameraman	
カルテ	(de:) (n) clinical records (de: Karte)	
カンニング	cunning;cheat	
ガイド	tour guide	
ガイドブック	guidebook	
ガレージ	garage (at house)	
キャッチ	catch	
キャリア	career;career government employee	
クイズ	quiz	
クラブ	club;crab	
クレーン	crane	
グラフ	graph	
グレー	grey;gray	
ゲスト	guest	
コーナー	corner	
コマーシャル	a commercial	
コミュニケーション	communication	
コメント	comment	
コンタクト	contact;contact lens	
コンテスト	contest	
コントラスト	contrast	
コントロール	control	
コンパス	compass	
サイクル	cycle	
サイズ	size	
サボる	to be truant;to be idle;to sabotage by slowness	
サンキュー	thank you	
サンタクロース	Santa Claus	
シート	seat;sheet	
システム	system	
シック	chic	
シナリオ	scenario	
ショー	show	
ショック	shock	
ジーパン	jeans (lit: jeans pants);dungarees	
ジャズ	jazz	
ジャンパー	jacket;jumper	
ジャンプ	jump	
ジャンボ	jumbo	
ジャンル	genre	
スタジオ	studio	
スチーム	steam	
ストライキ	strike	
ストレス	stress	
ストロー	straw	
ストロボ	stroboscope (lit: strobo);strobe lamp;stroboscopic lamp	
スピード	speed	
スプリング	spring	
スペース	space	
スポーツカー	sports car	
スラックス	slacks	
セール	sale	
セクション	section	
セックス	sexual intercourse	
セレモニー	ceremony	
センス	good sense (for music&nbsp;&nbsp;style&nbsp;&nbsp;tact&nbsp;&nbsp;etc.)	
ゼリー	1.&nbsp;&nbsp;jelly; 2.&nbsp;&nbsp;Jerry	
ソース	source	
ソックス	socks	
ソロ	solo	
タイトル	title	
タイピスト	typist	
タイマー	timer	
タイミング	timing	
タイム	time	
タイムリー	timely;run-batted-in (baseball);RBI	
タイヤ	tire;tyre	
タイル	tile	
タレント	talent;star;personality	
タワー	tower	
ダース	dozen	
ダウン	down	
ダブる	to coincide (fall on the same day);to have two of something;to repeat a school year after failing	
ダンプ	dump	
チームワーク	teamwork	
チェンジ	change	
チャイム	chime	
チャンネル	a channel	
ティッシュペーパー	tissue paper	
テレックス	telex;teletypewriter exchange	
データ	data	
デコレーション	decoration	
デザート	dessert	
デザイン	design	
デッサン	(fr:) (n) rough sketch (fr: dessin)	
デモンストレーション	demonstration	
トーン	tone	
トラブル	trouble (sometimes used as a verb)	
トランジスター	transistor	
ドライ	dry	
ドライクリーニング	dry cleaning	
ドライバー	driver;screwdriver	
ドライブイン	drive in	
ドリル	drill	
ナイター	game under lights (e.g. baseball) (lit: nighter);night game	
ナプキン	napkin	
ナンセンス	nonsense	
ニュー	new	
ニュアンス	nuance	
ネガ	(photographic) negative	
ノイローゼ	(de:) (n) neurosis (de: Neurose)	
ハンガー	hangar;(coat) hanger;hunger	
バー	bar	
バッジ	badge	
バット	bat;vat	
パジャマ	pajamas;pyjamas	
パチンコ	pachinko (Japanese pinball)	
パトカー	patrol car	
パンク	1.&nbsp;&nbsp;(abbr) puncture;bursting; 2.&nbsp;&nbsp;punk	
ヒント	hint	
ビールス	virus	
ビジネス	business	
ファイト	fight	
ファイル	file	
ファン	fan;fun	
フィルター	(camera) filter	
フェリー	ferry	
フォーム	foam;form	
フロント	front	
ブーツ	boots	
ブーム	boom	
ブザー	buzzer	
ブルー	blue	
ベース	base;bass	
ベスト	best;vest	
ベストセラー	best-seller	
ペア	pair;pear	
ホース	hose	
ホール	hall;hole	
ボイコット	boycott	
ボルト	volt;bolt	
ポーズ	pause	
ポイント	point	
ポジション	position	
ポット	pot	
ポンプ	pump	
マーク	mark	
マスコミ	mass communication	
マッサージ	massage	
ミスプリント	misprint	
ミセス	Mrs.	
ミュージック	music	
ミリ	milli-;10^-3	
ムード	mood	
メーカー	maker	
メッセージ	message	
メディア	media	
メロディー	melody	
モーテル	motel	
モニター	(computer) monitor	
ヤング	young	
ユニーク	unique	
ユニフォーム	uniform	
ライス	rice	
ラベル	label	
ランプ	lamp;ramp;headlight;light	
ルーズ	loose	
ルール	rule	
レース	race;lace	
レギュラー	regular	
レクリエーション	recreation	
レッスン	lesson	
レディー	lady	
レバー	lever;liver	
レンジ	range;stove	
レンタカー	hire car (lit: rent-a-car)	
レントゲン	X-ray (lit: Roentgen)	
ロープ	rope	
ローマ字	romanization;Roman letters	
ロマンチック	romantic	
ワット	watt	