会う	to meet	
青	blue	
青い	blue	
赤	red	
赤い	red	
明い	bright	
秋	autumn	
開く	to open,to become open	
開ける	to open	
上げる	to give	
朝	morning	
朝御飯	breakfast	
あさって	day after tomorrow	
足	foot,leg	
明日	tomorrow	
あそこ	over there	
遊ぶ	to play,to make a visit	
暖かい	warm	
頭	head	
新しい	new	
あちら	there	
暑い	hot	
熱い	hot to the touch	
厚い	kind, deep, thick	
あっち	over there	
後	afterwards	
あなた	you	
兄	(humble) older brother	
姉	(humble) older sister	
あの	that over there	
アパート	apartment	
あびる	to bathe,to shower	
危ない	dangerous	
甘い	sweet	
あまり	not very	
雨	rain	
飴	candy	
洗う	to wash	
ある	to be,to have (used for inanimate objects)	
歩く	to walk	
あれ	that	
いい/よい	good	
いいえ	no	
言う	to say	
家	house	
いかが	how	
行く	to go	
いくつ	how many?,how old?	
いくら	how much?	
池	pond	
医者	medical doctor	
いす	chair	
忙しい	busy,irritated	
痛い	painful	
一	one	
一日	(1) one day, (2) first of month	
いちばん	best,first	
いつ	when	
五日	five days, fifth day	
一緒	together	
五つ	five	
いつも	always	
犬	dog	
今	now	
意味	meaning	
妹	(humble) younger sister	
嫌	unpleasant	
入口	entrance	
居る	to be, to have (used for people and animals)	
要る	to need	
入れる	to put in	
色	colour	
いろいろ	various	
上	on top of	
後ろ	behind	
薄い	thin,weak	
歌	song	
歌う	to sing	
生まれる	to be born	
海	sea	
売る	to sell	
煩い	noisy,annoying	
上着	jacket	
絵	picture	
映画	movie	
映画館	cinema	
英語	English language	
ええ	yes	
駅	station	
エレベーター	elevator	
鉛筆	pencil	
おいしい	delicious	
多い	many	
大きい	big	
大きな	big	
大勢	great number of people	
お母さん	(honorable) mother	
お菓子	sweets, candy	
お金	money	
起きる	to get up	
置く	to put	
奥さん	(honorable) wife	
お酒	alcohol, rice wine	
お皿	plate, dish	
伯父/叔父	grandfather,male senior citizen	
教える	to teach,to tell	
押す	to push, to stamp something	
遅い	late,slow	
お茶	green tea	
お手洗い	bathroom	
お父さん	(honorable) father	
弟	younger brother	
男	man	
男の子	boy	
一昨日	day before yesterday	
一昨年	year before last	
大人	adult	
おなか	stomach	
同じ	same	
お兄さん	(honorable) older brother	
お姉さん	(honorable) older sister	
おばあさん	grandmother,female senior-citizen	
伯母さん/叔母さん	aunt	
お風呂	bath	
お弁当	boxed lunch	
覚える	to remember	
おまわりさん	friendly term for policeman	
重い	heavy	
おもしろい	interesting	
泳ぐ	to swim	
降りる	to get off, to descend	
終る	to finish	
音楽	music	
女	woman	
女の子	girl	
外国	foreign country	
外国人	foreigner	
会社	company	
階段	stairs	
買い物	shopping	
買う	to buy	
返す	to return something	
帰る	to go back	
かかる	to take time or money	
かぎ	key	
書く	to write	
学生	student	
かける	to call by phone	
傘	umbrella	
貸す	to lend	
風	wind	
風邪	a cold	
家族	family	
方	person, way of doing	
学校	school	
カップ	cup	
家庭	household	
角	a corner	
かばん	bag,basket	
花瓶	a vase	
紙	paper	
カメラ	camera	
火曜日	Tuesday	
辛い	spicy	
体	body	
借りる	to borrow	
軽い	light	
カレー	curry	
カレンダー	calendar	
川/河	river	
かわいい	cute	
漢字	Chinese character	
木	tree,wood	
黄色	yellow	
黄色い	yellow	
消える	to disappear	
聞く	to hear,to listen to,to ask	
北	north	
ギター	guitar	
汚い	dirty	
喫茶店	coffee lounge	
切手	postage stamp	
切符	ticket	
昨日	yesterday	
九	nine	
牛肉	beef	
牛乳	milk	
今日	today	
教室	classroom	
兄弟	(humble) siblings	
去年	last year	
嫌い	hate	
切る	to cut	
着る	to put on from the shoulders down	
きれい	pretty,clean	
キロ/キログラム	kilogram	
キロ/キロメートル	kilometre	
銀行	bank	
金曜日	Friday	
薬	medicine	
ください	please	
果物	fruit	
口	mouth,opening	
靴	shoes	
靴下	socks	
国	country	
曇り	cloudy weather	
曇る	to become cloudy,to become dim	
暗い	gloomy	
クラス	class	
グラム	gram	
来る	to come	
車	car,vehicle	
黒	black	
黒い	black	
警官	policeman	
今朝	this morning	
消す	to erase,to turn off power	
結構	splendid,enough	
結婚	marriage	
月曜日	Monday	
玄関	entry hall	
元気	health, vitality	
五	five	
公園	park	
交差点	intersection	
紅茶	black tea	
交番	police box	
声	voice	
コート	coat,tennis court	
コーヒー	coffee	
ここ	here	
午後	afternoon	
九日	nine days, ninth day	
九つ	nine	
午前	morning	
答える	to answer	
こちら	this person or way	
こっち	this person or way	
コップ	a glass	
今年	this year	
言葉	word,language	
子供	child	
この	this	
御飯	cooked rice,meal	
コピーする	to copy	
困る	to be worried	
これ	this	
今月	this month	
今週	this week	
こんな	such	
今晩	this evening	
さあ	well…	
財布	wallet	
魚	fish	
先	the future,previous	
咲く	to bloom	
作文	composition,writing	
差す	to stretch out hands,to raise an umbrella	
雑誌	magazine	
砂糖	sugar	
寒い	cold	
さ来年	year after next	
三	three	
散歩	to stroll	
四	four	
塩	salt	
しかし	however	
時間	time	
仕事	job	
辞書	dictionary	
静か	quiet	
下	below	
七	seven	
質問	question	
自転車	bicycle	
自動車	automobile	
死ぬ	to die	
字引	dictionary	
自分	oneself	
閉まる	to close,to be closed	
閉める	to close something	
締める	to tie	
じゃ/じゃあ	well then…	
写真	photograph	
シャツ	shirt	
シャワー	shower	
十	ten	
授業	lesson,class work	
宿題	homework	
上手	skillful	
丈夫	strong,durable	
しょうゆ	soy sauce	
食堂	dining hall	
知る	to know	
白	white	
白い	white	
新聞	newspaper	
水曜日	Wednesday	
吸う	to smoke,to suck	
スカート	skirt	
好き	likeable	
少ない	a few	
すぐに	instantly	
少し	few	
涼しい	refreshing	
ストーブ	heater	
スプーン	spoon	
スポーツ	sport	
ズボン	trousers	
住む	to live in	
スリッパ	slippers	
する	to do	
座る	to sit	
背	height,stature	
生徒	pupil	
セーター	sweater,jumper	
せっけん	economy	
背広	business suit	
狭い	narrow	
ゼロ	zero	
千	thousand	
先月	last month	
先週	last week	
先生	teacher,doctor	
洗濯	washing	
全部	all	
掃除	to clean, to sweep	
そうして/そして	and	
そこ	that place	
そちら	over there	
そっち	over there	
外	outside	
その	that	
そば	near,beside	
空	sky	
それ	that	
それから	after that	
それでは	in that situation	
大学	university	
大使館	embassy	
大丈夫	all right	
大切	important	
大好き	to be very likeable	
台所	kitchen	
たいへん	very	
たくさん	many	
高い	tall, expensive	
出す	to put out	
タクシー	taxi	
立つ	to stand	
たて	length,height	
建物	building	
頼む	to ask	
楽しい	enjoyable	
たばこ	tobacco,cigarettes	
たぶん	probably	
食べる	to eat	
食べ物	food	
卵	egg	
誰	who	
誕生日	birthday	
だんだん	gradually	
小さい	little	
小さな	little	
近い	near	
違う	to differ	
近く	near	
地下鉄	underground train	
地図	map	
茶色	brown	
ちゃわん	rice bowl	
ちょうど	exactly	
ちょっと	somewhat	
使う	to use	
疲れる	to get tired	
次	next	
着く	to arrive at	
机	desk	
作る	to make	
つける	to turn on	
勤める	to work for someone	
つまらない	boring	
冷たい	cold to the touch	
強い	powerful	
手	hand	
テープ	tape	
テーブル	table	
テープレコーダー	tape recorder	
出かける	to go out	
手紙	letter	
できる	to be able to	
出口	exit	
テスト	test	
では	with that...	
デパート	department store	
でも	but	
出る	to appear,to leave	
テレビ	television	
天気	weather	
電気	electricity,electric light	
電車	electric train	
電話	telephone	
戸	Japanese style door	
ドア	Western style door	
トイレ	toilet	
どう	how,in what way	
どうして	for what reason	
どうぞ	please	
動物	animal	
どうも	thanks	
遠い	far	
十日	ten days,the tenth day	
時々	sometimes	
時計	watch,clock	
どこ	where	
所	place	
年	year	
図書館	library	
どちら	which of two	
どっち	which	
とても	very	
どなた	who	
隣	next door to	
どの	which	
飛ぶ	to fly,to hop	
止まる	to come to a halt	
友達	friend	
土曜日	Saturday	
鳥	bird	
とり肉	chicken meat	
取る	to take something	
撮る	to take a photo or record a film	
どれ	which (of three or more)	
ナイフ	knife	
中	middle	
長い	long	
鳴く	animal noise. to chirp, roar or croak etc.	
無くす	to lose something	
なぜ	why	
夏	summer	
夏休み	summer holiday	
など	et cetera	
七つ	seven	
七日	seven days,the seventh day	
名前	name	
習う	to learn	
並ぶ	to line up,to stand in a line	
並べる	to line up,to set up	
なる	to become	
何	what	
二	two	
賑やか	bustling,busy	
肉	meat	
西	west	
日曜日	Sunday	
荷物	luggage	
ニュース	news	
庭	garden	
脱ぐ	to take off clothes	
温い	luke warm	
ネクタイ	tie,necktie	
猫	cat	
寝る	to go to bed,to sleep	
ノート	notebook,exercise book	
登る	to climb	
飲み物	a drink	
飲む	to drink	
乗る	to get on,to ride	
歯	tooth	
パーティー	party	
はい	yes	
灰皿	ashtray	
入る	to enter,to contain	
葉書	postcard	
はく	to wear,to put on trousers	
箱	box	
橋	bridge	
はし	chopsticks	
始まる	to begin	
初め/始め	beginning	
初めて	for the first time	
走る	to run	
バス	bus	
バター	butter	
二十歳	20 years old,20th year	
働く	to work	
八	eight	
二十日	twenty days,twentieth	
花	flower	
鼻	nose	
話	talk,story	
話す	to speak	
早い	early	
速い	quick	
春	spring	
貼る	to stick	
晴れ	clear weather	
晴れる	to be sunny	
半	half	
晩	evening	
パン	bread	
ハンカチ	handkerchief	
番号	number	
晩御飯	evening meal	
半分	half minute	
東	east	
引く	to pull	
弾く	to play an instrument with strings, including piano	
低い	short,low	
飛行機	aeroplane	
左	left hand side	
人	person	
一つ	one	
一月	one month	
一人	one person	
暇	free time	
百	hundred	
病院	hospital	
病気	illness	
昼	noon, daytime	
昼御飯	midday meal	
広い	spacious,wide	
フィルム	roll of film	
封筒	envelope	
プール	swimming pool	
フォーク	fork	
吹く	to blow	
服	clothes	
二つ	two	
豚肉	pork	
二人	two people	
二日	two days, second day of the month	
太い	fat	
冬	winter	
降る	to fall, e.g. rain or snow	
古い	old (not used for people)	
ふろ	bath	
文章	sentence,text	
ページ	page	
下手	unskillful	
ベッド	bed	
ペット	pet	
部屋	room	
辺	area	
ペン	pen	
勉強	to study	
便利	useful, convenient	
帽子	hat	
ボールペン	ball-point pen	
ほか	other, the rest	
ポケット	pocket	
欲しい	want	
ポスト	post	
細い	thin	
ボタン	button	
ホテル	hotel	
本	book	
本棚	bookshelves	
ほんとう	truth	
毎朝	every morning	
毎月	every month	
毎週	every week	
毎日	every day	
毎年	every year	
毎晩	every night	
前	before	
曲る	to turn,to bend	
まずい	unpleasant	
また	again,and	
まだ	yet,still	
町	town,city	
待つ	to wait	
まっすぐ	straight ahead,direct	
マッチ	match	
窓	window	
丸い/円い	round,circular	
万	ten thousand	
万年筆	fountain pen	
磨く	to brush teeth, to polish	
右	right side	
短い	short	
水	water	
店	shop	
見せる	to show	
道	street	
三日	three days, third day of the month	
三つ	three	
緑	green	
皆さん	everyone	
南	south	
耳	ear	
見る&nbsp;&nbsp;観る	to see, to watch	
みんな	everyone	
六日	six days, sixth day of the month	
向こう	over there	
難しい	difficult	
六つ	six	
村	village	
目	eye	
メートル	metre	
眼鏡	glasses	
もう	already	
もう一度	again	
木曜日	Thursday	
持つ	to hold	
もっと	more	
物	thing	
門	gate	
問題	problem	
八百屋	greengrocer	
野菜	vegetable	
易しい	easy, simple	
安い	cheap	
休み	rest,holiday	
休む	to rest	
八つ	eight	
山	mountain	
やる	to do	
夕方	evening	
夕飯	dinner	
郵便局	post office	
昨夜	last night	
有名	famous	
雪	snow	
ゆっくりと	slowly	
八日	eight days, eighth day of the month	
洋服	western-style clothes	
よく	often, well	
横	beside,side,width	
四日	four days, fouth day of the month	
四つ	four	
呼ぶ	to call out,to invite	
読む	to read	
夜	evening,night	
弱い	weak	
来月	next month	
来週	next week	
来年	next year	
ラジオ	radio	
ラジカセ / ラジオカセット	radio cassette player	
りっぱ	splendid	
留学生	overseas student	
両親	both parents	
料理	cuisine	
旅行	travel	
零	zero	
冷蔵庫	refrigerator	
レコード	record	
レストラン	restaurant	
練習	to practice	
廊下	corridor	
六	six	
ワイシャツ	business shirt	
若い	young	
分かる	to be understood	
忘れる	to forget	
私	(humble) I,myself	
渡す	to hand over	
渡る	to go across	
悪い	bad	
より、ほう	Used for comparison.	